'di	d i
'go	g o
'kin	k i n
'no	n o
'pacto	p a k t o
'pag	p a g
'to	t o
'wag	w a g
'y	i
'yan	y a n
'yo	y o q
'yong	y u ng
'yung	y o ng
a	q a
a-disi-syete	q a d i s i q s y e t e
a-uno	a q u n o
aabot	a q a b o t
aabutin	a q a b u t i n
aakayin	q a a k a y i n
aakyat	q a q a k y a t
aalis	q a a l i s
aangat	a q a ng a t
aanhin	a q a n h i n
aanihin	q a a n i h i n
aatasang	q a a t a s a ng
aawit	q a a w i t
aayaw	a q a y aw
ab	q a b
aba	q a b a
aba'y	q a b ay
aba-aba	q a b a q a b a
abaca	q a b a k a
abaka	q a b a k a
abing	q a b i ng
abo	q a b o
aboitiz	q a b oy t i z
abril	q a b r i l
abroad	q a b r o d
abs-cbn	ey b i q e s s i b i q e n
absence	ey b i q e s e n s
absorption	ey b i q e s o er p sh uh n
abutan-abutan	q a b u t a n q a b u t a n
abutin	q a b u t i n
access	q a k s e s
acids	q ae s i d s
acne	q a k n i
act	q a k t
activity	q a k t i v i t i
acute	q a k y u t
adb	q ey d i b i
added	q a d d e d
adhika	q a d h i k a
adik	q a d i k
administrasyon	q a d m i n i s t r a sh o n
administration	q a d m i n i s t r ey sh uh n
administrative	q a d m i n i s t r a t i v
administrator	q a d m i n i s t r a t o r
adobo	q a d o b o
adolescent	q a d o l e s s e n t
ads	q a d s
aerobics	q a e er u b e s i s
affairs	q a f e r s
afritada	q a f er i t a d a
ag	q a g
agad	q a g a d
agarang	q a g a r a ng
agawan	q a g a w a n
agawan-agawan	q a g a w a n q a g a w a n
agenda	q ey jh e n d a
agimat	q a g i m a t
ago	q a g o
agoncillo	q a g o n s i ly o
agos	q a g o s
agosto	q a g o s t o
agricultural	q a g r i k u l ch u r a l
agriculture	q a g r i k u l ch er
agrikultura	q a g r i k a l t u r a
aguinaldo	q a g i n a l d o
agustin	q a g u s t i n
ah	a
ahas	q a h a s
ahensya	a h e n sh a
ahensyang	a h e n sh a ng
ahkel	q a h k e l
aid	q a i d
aileen	q e l i n
airbus	q e r b u s
airline	q e er l ay n
airlines	q e er l ay n s
airport	q e er p o er t
airsick	q e r s i k
akala	q a k a l a
akin	q a k i n
aking	q a k i ng
aklat	q a k l a t
akma	q a k m a
akmang	q a k m a ng
ako	q a k o
ako'y	q a k oy
akong	q a k u ng
aksyunan	q a k sh u n a n
aktibong	q a k t i b o ng
alaala	q a l a a l a
alagaan	a l a g a q a n
alak	a l a k
alak-alakan	a l a k q a l a k a n
alam	a l a m
alamang	a l a m a ng
alamin	a l a m i n
alapaap	a l a p a q a p
alas	a l a s
alay	a l ay
albay	a l b ay
albert	a l b er t
alemanya	q a l i m a ny a
alfabeto	q a l f a b e t o
alfred	q a l f er e d
alikabok	a l i k a b u k
alimango	a l i m a ng o
alimango'y	a l i m a ng oy
alimangong	a l i m a ng o ng
alimpuyo	a l i m p u y o q
alin	a l i n
alin-alin	a l i n q a l i n
aling	a l i ng
alinmang	a l i n m a ng
alisin	a l i s i n
alitaptap	a l i t a p t a p
all	o l
allan	q a l a n
allen	q a l e n
allergic	q a l e er jh i k
allergy	q a l e er jh i
alliance	q a l a y a n s
almira	a l m i r a
almonte	a l m o n t e
almusal	a l m u s a l
alon	a l u n
alpa	q a l p a
alta	q a l t a
altapresyon	q a l t a p r e sh o n
alternatibo	q a l t er n a t i b o
alvin	q a l v i n
alyansa	q a ly a n s a
am	q a m
ama	q a m a
amando	q a m a n d o
amang	q a m a ng
ambassador	q a m b a s a d o r
ambon	q a m b o n
ambuklao	q a m b u k l aw
amco	q a m k o
america	q a m e r i k a
amerika	q a m e r i k a
amerikano	q a m e r i k a n o
amigo	q a m i g o
amihan	q a m i h a n
amin	q a m i n
aminadong	q a m i n a d o ng
aming	q a m i ng
amino	q a m i n o
amo	q a m o
amomongo	q a m o m o ng a
ampon	q a m p u n
an	q a n
anak	q a n a k
analyn	q a n a ly n
analyst	q a n a ly s t
and	q a n d
andiyan	q a n d i y a n
andyan	q a n d y a n
ang	q a ng
angel	q a n jh e l
angeles	q a ng e l e s
angelo	q a n jh e l o
anghel	a ng h e l
ani	q a n i
anibersaryo	a n i b er s a r i y o
anihin	q a n i h i n
aniko	a n i k o
anilao	a n i l aw
anim	a n i m
animnapu	a n i m n a p u
animnapu't	a n i m n a p u t
anino	q a n i n o
anit	q a n i t
anito	q a n i t o
aniya	q a ny a
anjo	q a n jh o
ann	q a n
anna	q a n a
anne	q a n
annual	q a n w a l
ano	q a n o
anong	q a n o ng
antayin	a n t a y i n
anthony	q a n th o n i
anti-fungal	q a n t i q f q u ng a l
antipolo	q a n t i p o l o
anu-ano	q a n u q a n o
anu-anong	q a n u q a n o ng
anuman	q a n u m a n
anumang	q a n u m a ng
anya	a ny a
anyaya	q a n y a y a
anyo	q a n y o
apat	a p a t
apatanapu't	a p a t a n a p u t
apatanpu't	a p a t a n p u t
apatnapu	a p a t n a p u
apatnapu't	a p a t n a p u t
apatnapung	a p a t n a p u ng
apaw	q a p aw
apdo	q a p d o
apec	q ey p e k
apektado	q a p e k t a d o
apo	q a p o
apoy	q a p oy
aprika	q a p r i k a
april	q ey p r i l
aprub	q a p r u b
aquatic	q a k a t i k
aquino	q a k i n o
aralin	q a r a l i n
aralin-aralin	q a r a l i n q a r a l i n
araw	q a r aw
araw-araw	q a r aw q a r aw
are	q a r e
argel	q a r g e l
ari	q a r i
ariel	q a r i y e l
arlene	q a r l i n
armpit	q a r m p i t
arnel	q a r n e l
arnold	q a r n ow l d
arroyo	a r o y o q
arroz	a r u z
artist	q a er t i s
artistang	q a er t i s t a ng
arup	q a r u p
asahan	q a s a h a n
asal	q a s a l
asawa	q a s a w a
ascott	q a s k o t
asean	q a s i n
ashley	q a sh l i
asia	q ey sh a
asian	q ey sh a n
asin	a s i n
asis	q a s i s
ask	q a s
aso	a s o
aspe	q a s p e
assignment	q a s i g n m e n t
assistant	q a s i s t a n t
association	q a s o s i ey sh uh n
asthma	q a s t m a
asukal	a s u k a l
asul	q a s u l
asya	q a sh a
at	q a t
ata	q a t a
atake	q a t ey k
atay	q a t ay
atbp	q a t b i p i
ate	q a t e
atensiyon	q a t e n sh o n
ati'y	q a t i
atin	q a t i n
ating	q a t i ng
atleta	q a t l e t a
atraso	q a t r a s o
atrium	q a t er i u m
atsara	q a t s a r a
attack	q a t o er a k
attorney	q a t o er o n i
atulungan	q a t u l u ng a n
aurora	aw r u r a
australia	q a a s t r a ly a
avenue	q a v i n w e
average	q a v er e jh
aviation	q a v i ey sh uh n
awa	q a w a
awang	q a w a ng
awareness	q a w a r e n e s
away	aw ay
awit	q a w e t
awitin	q a w i t i n
awla'y	aw l ay
ay	ay
ayala	q a y a l a
ayaw	q a y aw
ayon	q a y u n
ayos	q a y o s
ayun	q a y o n
ayusin	q a y u s i n
azul	q a z u l
b	b
ba	b a
ba't	b a t
baba	b a b a
baba-baba	b a b a q b a b a q
bababa	b a q b a q b a q
bababaan	b a b a b a q a n
babad	b a b a d
babae	b a b a
babagsak	b a b a g s a k
babalik	b a b a l i k
babasahin	b a b a s a h i n
babayaran	b a b a y a r a n
babayuhin	b a b a y u h i n
baboy	b a b oy
bacolod	b a k o l o d
bacolod-silay	b a k u l o d s i l ay
bacterial	b a k t e r i y a l
bader	b a d er
badha	b a d h a q
bag	b a g
baga	b a g a
bagao	b a g o
bagay	b a g ay
bagkus	b a g k u s
bago	b a g o q
bagong	b a g o ng
bagoong	b a g o q o ng
bagsak	b a g s a k
baguhin	b a g u h i n
baguio	b a g y o
bagyo	b a g y o q
baha	b a h a q
bahagi	b a h a g i
bahaging	b a h a g i ng
bahagyang	b a h a g y a ng
bahay	b a h ay
bahindi	b a h i n d i q
bahong	b a h o ng
bait	b a q i t
baka	b a k a
baka-baka	b a k a q b a k a
bakal	b a k a l
bakas	b a k a s
bakas-bakas	b a k a s q b a k a s
bakasyon	b a k a sh u n
bakit	b a k i t
bakla	b a k l a
bakod	b a k o d
bakuna	b a k u n a
balae	b a l a
balahibo	b a l a h i b o
balak	b a l a k
balakang	b a l a k a ng
balakyot	b a l a k y o t
balang	b a l a ng
balat	b a l a t
balbas	b a l b a s
baler	b a l er
balikat	b a l i k a t
balikatin	b a l i k a t i n
balisawsaw	b a l i s a w s aw
balita	b a l i t a q
balitang	b a l i t a ng
balo	b a l o
balon	b a l u n
balunbalunan	b a l u n b a l u n a n
balut	b a l o t
bamboo	b a m b u
banaag	b a n a q a g
banal	b a n a l
banaue	b a n a w e
bancasi	b a n k a s i
banco	b a ng k o q
band	b a n d
bandang	b a n d a ng
bang	b a ng
banggitin	b a ng g i t i n
bangin	b a ng i n
bangkang	b a ng k a ng
bangko	b a ng k o
bangko-bangko	b a ng k o b a ng k o
bangoy	b a ng oy
bangungot	b a ng u ng o t
bangus	b a ng u s
bank	b a ng k
bankard	b a ng k a er d
banking	b a ng k i ng
bansa	b a n s a
bansa't	b a n s a t
bansa'y	b a n s ay
bansang	b a n s a ng
bantas	b a n t a s
bantay	b a n t ay
bantog	b a n t o g
bao	b a q o
bao't	b a q o t
baon	b a q o n
bar	b a r
bara	b a r a
bara-bara	b a r a b a r a
barangay	b a r a ng g ay
barbwire	b a r b w i r e
bariles	b a r e l s
barkada	b a er k a d a
barong	b a r o ng
basa	b a s a
basa-basa	b a s a q b a s a
basahan	b a s a h a n
basahin	b a s a h i n
basahing	b a s a h i ng
basang-basa	b a s a ng b a s a
base	b a s e
basilan	b a s i l a n
basketball	b a s k e t b o l
basketbol	b a s k e t b o l
baso	b a s o
basura	b a s u r a
basurahan	b a s u r a h a n
basurero	b a s u r e r o
bata	b a t a
bata't	b a t a t
bata-bata-bata	b a t a b a t a b a t a
batac	b a t a k
batang	b a t a ng
batangas	b a t a ng g a s
batas	b a t a s
bataw	b a t aw
bataw-bataw	b a t a w b a t aw
batay	b a t ay
batchoy	b a ch oy
baterina	b a t e er i n a
bathala	b a t h a l a
bati	b a t i
batiin	b a t i q i n
bato	b a t o
batok	b a t o k
bautista	b aw t i s t a
bawa't	b a w a t
bawal	b a w a l
bawat	b a w a t
bay	b ay
bayaan	b a y a q a n
bayad	b a y a d
bayag	b a y a g
bayan	b a y a n
bayang	b a y a ng
bayani	b a y a n i
bayaning	b a y a n i ng
bayaran	b a y a r a n
bayarin	b a y a r i n
bayaw	b a y aw
bayay	b a y ay
baybay	b ay b ay
bayona	b a y o n a
bayugan	b a y u g a n
bayview	b ay v y u
baywalk	b ey w o k
baywang	b ey w a ng
bb	b
bdo	b i d i q o
bea	b i
beach	b i ch
beans	b i n s
beer	b e er
belle	b e l
ben	b e n
benchmark	b e n ch m a er k
benjamin	b e n jh a m i n
benjie	b e n jh i
bentahan	b e n t a h a n
berde	b e r d e
bernardo	b er n a er d u
bernie	b er n i
beses	b e s e s
bewang	b e w a ng
bfar	b f a r
bibig	b i b i g
bibigyan	b i b i g y a n
bibilhin	b i b i l h i n
bibili	b i b i l i q
bibingka	b i b i ng k a
bigas	b i g a s
biglaang	b i g l a q a ng
biglang	b i g l a ng
bigote	b i g o t e
bigyan	b i g y a n
bihag	b i h a g
bihira	b i h i r a
biko	b i k o
biktima	b i k t i m a
bilang	b i l a ng
bilangin	b i l a ng i n
bilao	b i l aw
bilas	b i l a s
bilhin	b i l h i n
bili	b i l i q
bilihin	b i l i h i n
bilis	b i l i s
bilisan	b i l i s a n
billion	b i ly uh n
billlion	b i l ly uh n
bilog	b i l o g
bilugan	b i l u g a n
bilyong	b i ly o ng
bimbim	b i m b i m
bimbo	b i m b o
binabaan	b i n a b a q a n
binabad	b i n a b a d
binabanggit	b i n a b a ng g i t
binabasa	b i n a b a s a
binabati	b i n a b a t i q
binabayo	b i n a b a y o q
binagoongan	b i n a g o q o ng a n
binagsakan	b i n a g s a k a n
binalot	b i n a l o t
binanggit	b i n a ng g i t
binanlian	b i n a n l i q a n
binasa	b i n a s a
binatilyo	b i n a t i ly o q
binayaran	b i n a y a r a n
binibentang	b i n i b e n t a ng
binibigyang	b i n i b i g y a ng
binibili	b i n i b i l i q
binibining	b i n i b i n i ng
binigyan	b i n i g y a n
binili	b i n i l i q
biniyayaan	b i n a y a y a q a n
binobola	b i n o b o l a
binondo	b i n o n d o
bintana	b i n t a n a
bintanang	b i n t a n a ng
binti	b i n t i
binubuhay	b i n u b u h ay
binubunot	b i n u b u n o t
binubusisi	b i n u b u s i s i
binubusog	b i n u b u s o g
binuksan	b i n u k s a n
binulag	b i n u l a g
binuo	b i n u q u
binuro	b i n u r o
binusa	b i n u s a
biodiesel	b y o d y e s e l
biofuels	b i ao f w e l s
bir	b i r
biro	b i r o
biru-birong	b i r u q b i r o ng
bisagra	b i s a g r a
bisaya	b i s a y a
biscocho	b i s k o ch o q
bisig	b i s i g
bisita	b i s i t a
bisitahin	b i s i t a h i n
bitag	b i t a g
bitak-bitak	b i t a k b i y t a k
bitamina	b i t a m i n a
bituka	b i t u k a
biyak	b i y a k
biyaya	b i y a y a
biyaya'y	b iy ay ay
biyenan	b i y e n a n
biyernes	b y e r n e s
biyuda	b y u d a
biyudo	b y u d o
black	b l a k
blended	b l e n d e d
bloc	b l a
blood	b l uh d
blue	b l u
bluewater	b l u w o t er
blvd	b o l e v a r d
boao	b o aw
board	b o a er d
bobby	b a b i
body	b u d i
bogo	b o g o q
bonds	b u n d s
bonifacio	b o n i f a sh o
book	b o o k
boracay	b o er a k ay
borongan	b u r o ng a n
boses	b o s e s
boss	b o s
boston	b o s t o n
botika	b u t i k a
boy	b uy
bpi	b i p i q ay
bpos	b p o s
bra	b r a
braso	b r a s o
bread	b r e d
breakfast	b r e q a k f a s t
brewery	b r u w er i
bridge	b er i d jh
brilyante	b er i ly a n t e
brion	b r I y o n
broadcast	b er o d k ae s t
broadcasting	b er o d k a s t i ng
bronchitis	b er o n ch ay t i s
bronzeok	b er o n s o k
brothers	b er o d er s
brown	b r aw n
bsp	b i e s p i
bubong	b u b o ng
bubukol	b u b u k o l
bubuyog	b u b u y o g
budget	b a jh e t
bueno	b w e n o
bughaw	b u g h aw
bugso	b u g s o
buhat	b u h a t
buhawi	b u h aw i q
buhay	b u h ay
buhay-buhay	b u h ay q b u h ay
buhay-pilipino	b u h ay q p i l i p i n o
buhok	b u h o k
buhos	b u h o s
buhusan	b u h u s a n
buka	b u k a
bukang-liwayway	b u k a ng l i w a y w ay
bukas	b u k a s
bukas-bukas	b u k a s q b u k a s
bukas-kamay	b u k a s q k a m ay
bukid	b u k i d
bukidnon	b u k i d n u n
bukirin	b u k i r i n
buko	b u k o
bukod	b u k o d
bukol	b u k o l
bukong-bukong	b u k u ng b u k o ng
buksan	b u k s a n
buksi	b u k s i
bulacan	b u l a k a n
bulag	b u l a g
bulaklak	b u l a k l a k
bulkang	b u l k a ng
bulletin	b u l e t i n
bulo-bulo	b u l o b o l o
bulong	b u l o ng
bumaba	b u m a b a
bumagsak	b u m a g s a k
bumahagi	b u m a h a g i
bumalik	b u m a l i k
bumasa	b u m a s a
bumati	b u m a t i
bumawi	b u m a w i
bumbay	b u m b ay
bumibilang	b u m i b i l a ng
bumilang	b u m i l a ng
bumili	b u m i l i
bumubulag	b u m u b u l a g
bumubuwag	b u m u b u w a g
bumukod	b u m u k o d
bumulusok	b u m u l u s o k
bumuo	b u m u q o
bundok	b u n d o k
bunga	b u ng a
bungang	b u ng a ng
bunganga	b u ng a ng a
bungi	b u ng i q
bunrok	b u n r o k
bunso	b u n s o
bunsod	b u n s u d
buntong-hininga	b u n t o ng h i n i ng a
buntot	b u n t o t
bunutin	b u n u t i n
bunye	b u n y e
buo	b u q o
buod	b u q o d
buong	b u q o ng
burahin	b u r a h i n
bureau	b y u er o
burnham	b u r n h a m
burukrasya	b u r u k er a sh a
bus	b u s
buses	b u s e s
busy	b u s i
but	b u t
butas	b u t a s
butas-butas	b u t a s q b u t a s
buto	b u t u
butong	b u t o ng
butuan	b u t u q a n
buwan	b u w a n
buwang	b u w a ng
buwaya	b u w a y a
buwis	b u w i s
cabadbaran	k a b a d b a r a n
cagayan	k a g a y a n
cajote	k a h o t e
caldo	k a l d o
caliraya	k a l i r a y a
call	k o l
caloocan	k a l o q o k a n
caltex	k a l t e k s
camille	k a m i l
camp	k a m p
cancer	k ae n s er
canton	k a n t o n
carcar	k a er k a r
card	k a er d
career	k a r e er
caring	k a r i ng
carl	k a er l
carlo	k a r l o
carne	k a er n
carol's	k a r o l s
carpio	k a r p y o q
carrageenan	k a r a jh i ng a n
carry	k e er i
casa	k a s a
case	k a s e
casino	k a s i n o
castillo	k a s t i ly o
castro	k a s t r o
catbalogan	k a t b o l o g a n
cathedral	k a th i d r a l
catherine	k a th e er i n
cavite	k a v i t e
cebu	s e b u
cell	s e l
cellphone	s e l f ow n
cells	s e l s
cellular	s e l y u l a r
cely	s e ly
centavos	s e n t a v o s
center	s e n t er
centro	s e n t r o
cereals	s e r i y a l s
challenge	ch a l e n jh
champorado	ch a m p o r a d o
charge	ch a r jh
checkpoint	ch e k p oy n t
chemrez	ch e m r e z
cherry	ch e r i
chief	ch i f
children	ch i l d r e n
chili	ch i l i q
china	ch ay n a
chinabank	ch ay n a b a ng k
chinatown	ch ay n a t aw n
chocolate	ch o c o l ey t
chopsuey	ch a p s uy
chowking	ch aw k i ng
christian	k r i s ch a n
christine	k r i s t i n
christmas	k r i s t m a s
christopher	k r i s t o f er
christy	k r i s t i
cigar	s i g a r
circumcised	s i r k u m k v ay
citadel	s i t a d e l
city	s i t i
clark	k l a er k
class	k l a s
classmates	k l a s m ey t s
claudia	k l aw jh a
clotrimazole	k l ow t r i m a z o l
clubs	k l uh b s
cng	k
co-amoxiclav	k o q a m o k s i k l v
cocido	k o s i d o
colonscopy	k o l o n s k o p i
comedy	k o m e jh
commercial	k o m er sh a l
commission	k o m i s sh o n
committee	k o m i t i
communications	k o m y u n i k ey sh uh n s
community	k o m e n i t i
companies	k o m p a n i s
company	k o m p a n i
complex	k o m p l e k s
comportable	k uh m p o r t a b l
composite	k uh m p o s i t
compressed	k ao m p er e s d
con	k o n
concepcion	k o n s e p sh o n
conjunctivitis	k o n jh a ng sh v ay t i s
construction	k o n s t er uh k sh uh n
consultants	k o n s u l t a n t s
consumers	k o n s u m er s
container	k o n t ey n er
coordinating	k o o er d i n a t i ng
corporation	k o er p o er ey sh o n
corregidor	k o r e g i d o r
cost	k o s t
cotabato	k o t a b a t o
country	k aw n t r i
cover	k a v er
cr	k er
cream	k r i y a m
credit	k r e d i t
crimson	k er i m s o n
criselda	k er i s e l d a
crispy	k er i s p i
cristina	k er i s t i n a
crown	k r aw n
crowne	k er aw n
cruz	k er u s
cure	k y u er
da	d a
daan	d a q a n
daanan	d a q a n a n
daang	d a q a ng
dadaan	d a d a q a n
dadalhin	d a d a l h i n
dadami	d a d a m i
dagat	d a g a t
dagdag	d a g d a g
dagdagan	d a g d a g a n
dagling	d a g l i ng
dagok	d a g o k
dahan-dahang	d a h a n q d a h a ng
dahil	d a h i l a n
dahilan	d a h i l a n
dahilang	d a h i l a ng
dahon	d a h o n
daig	d a q i g
daigdig	d a q i g d i g
daily	d a q i l i
daing	d a q i ng
dakdak	d a k d a k
dakila	d a k i l a
dakilang	d a k i l a ng
dako	d a k o q
dakong	d a k o ng
dala	d a l a
dala-dala-dala	d a l a d a l a d a l a
dala-dalang	d a l a q d a l a ng
dalaga	d a l a g a
dalagita	d a l a g i t a
dalandan	d a l a n d a n
dalang	d a l a ng
dalas	d a l a s
dalasan	d a l a s a n
dalawa	d a l a w a
dalawampu	d a l a w a m p u
dalawampu't	d a l a w a m p u t
dalawampung	d a l a w a m p u ng
dalawang	d a l a w a ng
dalawin	d a l a w i n
daldal	d a l d a l
dali-dali	d a l i d a l i q
daliri	d a l e r i
dam	d a m
dambuhalang	d a m b u h a l a ng
damdamin	d a m d a m i n
damdaming	d a m d a m i ng
dami	d a m i
damit	d a m i t
damo	d a m o q
damong-dagat	d a m o ng d a g a t
damputin	d a m p u t i n
dangal	d a ng a l
dangkal	d a ng k a l
daniel	d a ny e l
danielle	d a ny e l
dante	d a n t e
dapat	d a p a t
dapit-tanghali	d a p i t t a ng h a l i q
dapit-umaga	d a p i t q u m a g a
dapithapon	d a p i t h a p o n
dar	d a r
darating	d a r a t i ng
dark	d a er k
datapuwa't	d a t a p u w a t
dati	d a t i
dati'y	d a t i
dating	d a t i ng
datos	d a t o s
datu	d a t o
davao	d a v aw
davos	d a v o s
daw	d a w
days	d a y s
dayuhan	d a y u h a n
dayuhang	d a y u h a ng
dbp	d i b i p i
de	d e
de-kaledad	d e k a l e d a d
deadline	d e d l ay n
dealing	d e l i ng
debt	d e b t
december	d i s e m b er
dedma	d e d m a
dekada	d i k a d a
dekadang	d i k a d a ng
del	d e l
dela	d e l a
delikadong	d i l i k a d o ng
delos	d e l o s
deluxe	d i l o k s i
demanding	d e m a n d i ng
demokrasya	d e m o k er a sh a
dengue	d e n g e
denise	d e n i s
dennis	d e n i s
departamento	d e p a r t a m e n t o
department	d e p a er t m e n t
depektibong	d e p e k t i b o ng
depresyon	d e p r e sh o n
deretsahin	d i r i ch a h i n
deretso	d i r i ch u
desk	d e s k
destination	d e s t i n a sh uh n
determinasyon	d e t e er m i n a sh y u n
development	d e v e l o p m e n t
dfa	d f a
di	d i
di-masamang	d i m a s a m a ng
di-matalinong	d i m a t a l i n o ng
diabetes	jh a b e t s
diabetic	jh a b e t i k
diamond	d a y a m o n d
dianne	d a y a n
dibdib	d i b d i b
dibersiyon	d i b e r s i y o n
diesel	d i s e l
digital	d i jh i t a l
digma	d i g m a
digmaan	d i g m a q a n
diko	d i k o
dila	d i l a
dilao	d i l aw
dilaw	d i l aw
dili	d i l i
dili't	d i l i t
diligan	d i l i g a n
diliman	d i l i m a n
din	d i n
dina	d i n a
dinaan	d i n a q a n
dinadala	d i n a d a l a
dinaig	d i n a q i g
dinaing	d i n a q i ng
dinala	d i n a l a
dinaluhan	d i n a l u h a n
dinatnan	d i n a t n a n
dindo	d i n d o
ding	d i ng
dingding	d i ng d i ng
dinggin	d i ng g i n
dini	d i n i
dini-demolish	d i n i q d e m o l i sh
dinilig	d i n i l i g
dininig	d i n i n i g
diniskwento	d i n i s k w e n t o
dinuguan	d i n u g u q a n
diosdado	jh o s d a d o
dipolog	d i p o l o g
dir	d e r
direct	d ey r e k t
dirediretsuhin	d i r e d i r e t s u h i n
direksyon	d i r e k sh o n
direktang	d i r e k t a ng
direktiba	d i r e k t i b a
dis	d i s
discount	d i s k aw n t
discovery	d i s k a v er i
diskarte	d i s k a r t e
diskwento	d i s k w e n t o
distance	d i s t a n s
distrito	d i s t r i t o
disyembre	d i sh e m b r e
dito	d i t o
dito'y	d i t oy
diumano	d i q u m a n o
dive	d ay v
diwa	d i w a
diwa't	d i w a t
diwang	d i w a ng
diyamante	d i y a m a n t i
diyan	d i y a n
diyos	jh o s
dmci	d i m s i q ay
dobleng	d o b l e ng
document	d o k u m e n t
dodoblehin	d u d o b l e h i n
doe	d o
dof	d o v
dok	d o k
doktor	d o k t o r
doktora	d o k t o r a
dokumento	d o k u m e n t o
dole	d o l
dollars	d o l a er s
dolyar	d o ly a r
domestic	d o m e s t i k
domingo	d o m i ng o
dominic	d o m i n i k
don	d o n
don't	d o n t
donald	d o n a l d
donya	d o ny a
doon	d o q o n
doreen	d o r i n
dost	d i q ow e s t i
double	d o a b l
drawer	d r a w er
drayber	d r ay b e r
dream	d r i y a m
drowing	d r aw i ng
dti	d i t i q ay
dto	d t o
dudukutin	d u d u k u t i n
dugo	d u g u q
dulang	d u l a ng
dulcinea	d u l ch i n e y a
dulo	d u l o
dulot	d u l o t
dumadaan	d u m a d a q a n
dumadalaw	d u m a d a l a w
dumadami	d u m a d a m i
dumagsa	d u m a g s a
dumaguete	d u m a g e t i
dumalaw	d u m a l aw
dumalo	d u m a l o
dumaloy	d u m a l oy
dumami	d u m a m i
dumapa	d u m a p a
dumapo	d u m a p o q
dumaramdam	d u m a r a m d a m
dumating	d u m a t i ng
dumi	d u m i
dumihan	d u m i h a n
dumulog	d u m u l o g
dumumi	d u m u m i
dungis	d u ng i s
duon	d o q o n
durano	d u r a n o
dureza	d o r e z a
dusit	d u s i t
duwag	d u w a g
dwight	d w ay t
dyan	d y a n
dzxl	d z k s l
e	q i
e-vat	i v a t
earthquake	q er th k ey k
eastern	q i s t er n
eastwood	q e s t w u d
ecija	q i s i y a
economic	q i k o n o m i k
edad	e d a d
edc	e d s i
edita	e d i t a
edsa	e d s a
edwin	e d w i n
eh	q e
eight	q ey t
eighteen	q ey t i n
eighty	q ey t i
eighty-nine	q ey t i n ay n
eighty-seven	q ey t i s e v e n
ekonomiya	q e k o n o m i y a
eksam	q e k s a m
eksorsismo	q e k s o r s i s m o
ektarya	q e k t a r y a
ektaryang	q e k t a r y a ng
el	e l
elaine	e l ey n
elektrisidad	e l e k t r i s i d a d
elemento	e l e m e n t o
elijah	e l ay jh a
eliza	e l i z a
elizabeth	e l i z e b e th
elmer	e l e m er
embutido	e m b u t i d o
emil	q e m i l
emilio	q e m i ly o q
emma	q e m m a
employment	q e m p l oy m e n t
energy	e n e er jh i
enerhiya	e n e r h i y a
enero	e n e r o
engineers	q e n jh i n i er s
engkantado	q e ng k a n t a d o
engkanto	q e ng k a n t o
enrico	e n r i k o
ensaymada	e n s ay m a d a
enterprising	e n t er p r i s i ng
entertainment	e n t er t ey n m e n t
entrepreneurs	e n t r e p r e n e er s
environment	q e n v i r o n m e n t
epektibo	q e p e k t i b o
epekto	q e p e k t o
equation	q e k ey sh uh n
equitable	q i k w i t a b uh l
eric	q e r i k
ericka	e er i k a
erine	e er i n
eroplano	e er o p l a n o
erwin	e er w i n
escolar	q e s k o l a r
eskwelahan	q e s k w e l a h a n
espana	q e s p a ny a
espanya	q e s p a ny a
espanyol	q e s p a ny o l
espesyal	q e s p e sh y a l
establishments	q e s t a b l i sh m e n t s
establisimyento	q e s t a b l i sh i m e n t o
estado	e s t a d o
estados	e s t a d o s
estate	q e s t ey t
estudyante	q e s t u jh a n t i
ethanol	q e th a n o l
eto	e t o
eton	i t u n
etong	i t o ng
eu	q i y u
europa	y u r o p a
europeo	y u r o p e y o
evelyn	q e v e ly n
exchange	e k s ch ey n jh
executive	q e k s e k y u t i b
expensive	q e k s p e n s i v
expert	q e k s p er t
exploration	q e k s p l u er ey sh o n
export	q e k s p o er t
exporter	q e k s p o er t er
exporters	q e k s p o er t er s
external	q e k s t er n a l
extra	q e k s t r a
eyes	q ay s
falls	f o l s
family	f a m i ly
far	f a r
faster	f a s t e r
fatigue	f ey sh g e
favilla	f a v i ly a
faye	f a y e
fecal	f i k a l
federal	f e d e r a l
felix	f i l i k s q
fernando	f er n a n d u
festival	f i s t i v a l
fever	f i v er
field	f i l d
fifty	f i f t i
figure	f i g y u er
filinvest	f i l i n v e s t
filipino	f i l i p i n o
filipinos	f i l i p i n o s
finance	f i n a n s
financial	f ay n a n sh a l
firm	f er m
first	f er s
fish	f i sh
fisheries	f i sh e er i s
five	f ay v
five-point	f ay v p oy n t
flan	f l a n
flash	f l a sh
fleuris	f l o r i s
flores	f l o r e s
fobt	f o b t
follow-up	f o l ow q u p
food	f u d
foods	f a d s
football	f u t b o l
for	f o er
force	f o er s
foreign	f o er ay n
fort	f o er t
forty	f o er ch
forty-four	f o er ch i f aw r
forum	f o er uh m
four	f aw r
four-day	f aw r d ay
fourty	f aw r t i
francisco	f er a n s i s k o
fraport	f er a p o er t
fraser	f er ey s e er
fraud	f er a u d
fred	f er e d
fuego	f w e g o
fungal	f q u ng a l
fungi	f u ng i q
furnitures	f er ny ch er s
g	g
ga	g a
gaano	g a q a n o
gaaral	g a q a r a l
gaas	g a a s
gab-i	g a b q i
gabahid	g a b a h i d
gabay	g a b ay
gabi	g a b i
gabi-gabi	g a b i q g a b i
gabing	g a b i ng
gabok	g a b o k
gabriel	g a p r i y e l
gabriela	g a p r i y e l a
gaga-gaga	g a g a g a g a q
gagaling	g a g a l i ng
gagamit	g a g q a m i t
gagamitin	g a g q a m i t i n
gagastos	g a g a s t o s
gagawin	g a g a w i n
gal	g a l
galactose	g a l a k t o s e
galactosemia	g a l a k t o s e m i y a
galang	g a l a ng
galang-galang	g a l a ng q g a l a ng
galang-galangan	g a l a ng q g a l a ng a n
galera	g a l e r a
galing	g a l i ng
galit	g a l i t
galleria	g a l er i y a
gamay	g a m ay
gamit	g a m i t
gamit-gamit	g a m i t q g a m i t
gamitin	g a m i t i n
gamot	g a m o t
gamugamo	g a m u g a m o
gamugamong	g a m u g a m o ng
gamutin	g a m u t i n
gan-on	g a n q o n
ganang	g a n a ng
ganap	g a n a p
ganda	g a n d a
gandahan	g a n d a h a n
gang	g a ng
ganid	g a n i d
ganito	g a n i t o
ganitong	g a n i t o ng
ganoon	g a n o n
ganoong	g a n o q o ng
ganti	g a n t i
gantimpala	g a n t i m p a l a
ganun	g a y u n
ganyang	g a ny a ng
garcia	g a er s i y a
garden	g a er d i n
garin	g a r i n
gas	g a s
gasolina	g a s u l i n a
gastusin	g a s t u s i n
gatas	g a t a s
gawa	g a w a
gawad	g a w a d
gawain	g a w a q i n
gawaing-dagat	g a w a q i ng d a g a t
gawin	g a w i n
gawing	g a w i ng
gaya	g a y a
gayo'y	g a y oy
gayon	g a y u n
gayong	g a y o ng
gayun	g a y u n
gayundin	g a y u n d i n
gayunman	g a y u n m a n
gdp	jh i d i p i
gen	jh e n
general	jh e n er a l
generation	jh e n e r ey sh uh n
generic	jh e n er i k
geraldine	jh e r a l d i n
german	jh e r m a n
gerontologist	jh e r u n t o l o jh e s t
gestational	jh e s t ey sh u n a l
gigisingin	g i g i s i ng i n
gilagid	g i l a g i d
gilas	g i l a s
gimik	g i m i k
ginagambala	g i n a g a m b a l a
ginagas	g i n a g a s
ginagawa	g i n a g a w a
ginamit	g i n a m i t
ginang	g i n a ng
ginastos	g i n a s t o s
ginawa	g i n a w a
ginebra	h i n i b r a
ginhawa	g i n h a w a
ginigiba	g i n i g i b a
ginisa	g i n i s a
ginoong	g i n o q o ng
ginto	g i n t o
gir	g e r
gising	g i s i ng
gitna	g i t n a
glaiza	g l a i z a
global	g l o b a l
globe	g l ow b
gloria	g l o r i y a
gma	g m a
gmatsing	g m a ch i ng
go-signal	g o q s i g n a l
gobyerno	g o b y e e r n o
goccs	jh i q ow s i s i s
gokongwei	g o k o ng w e i q
golf	g o l f
goma	g o m a
gonorrhea	g o n o r h e
good	g u q u d
gorilya	g o r i ly a
government	jh i q ow v er n m e n t
governonr	jh i q ow v er n o n r
governor	jh i q ow v er n o r
grace	g r ey s
grade	g r ey d
grand	g r a n d
greasy	g er i s i
green	g r i n
greenbelt	g r i n b e l t
grey	g r ey
gross	g er o s
growth	g r aw th
grupo	g r u p u
guam	g a m
gubat	g u b a t
guevara	g e v a er a
guguhitan	g u g u h i t a n
guhit	g u h i t
guided	g i jh d
guihulngan	g i h u d ng a n
guimaras	g i m a er a s
guinataan	g i n a t a q a n
guisado	g i s a d o
gulat	g u l a t
gulat-gulat	g u l a t q g u l a t
gulay	g u l ay
gulo	g u l o
gulong	g u l o ng
gulugod	g u l u g u d
gumagaan	g u m a g a q a n
gumagamit	g u m a g a m i t
gumaganap	g u m a g a n a p
gumaganda	g u m a g a n d a
gumagawa	g u m a g a w a
gumalaw-galaw	g u m a l aw q g a l aw
gumaling	g u m a l i ng
gumamit	g u m a m i t
gumanda	g u m a n d a
gumanti	g u m a n t i
gumapang	g u m a p a ng
gumawa	g u m a w a
gumising	g u m i s i ng
gumuhit	g u m u h i t
gumuwapo	g u m w a p o
gupitin	g u p i t i n
guro	g u r o
gusting	g u s t i ng
gusto	g u s t o
gustong	g u s t o ng
gustong-gusto	g u s t o ng q g u s t o
gutom	g u t u m
gutom-gutom	g u t o m q g u t u m
guzman	g u z m a n
ha	h a
haba	h a b a
haba-haba	h a b a h a b a
habagat	h a b a g a t
habang	h a b a ng
had	h a d
hagdan-hagdang	h a g d a n h a g d a ng
hagdanan	h a g d a n a n
hagibis	h a g i b i s
hahatiin	h a h a t i q i n
haka-haka	h a k a h a k a q
hakbang	h a k b a ng
hakbangin	h a k b a ng i n
hala	h a l a
halabos	h a l a b o s
halaga	h a l a g a
halagang	h a l a g a ng
halakhak	h a l a k h a k
halal	h a l a l
halalan	h a l a l a n
halaman	h a l a m a n
halamang-dagat	h a l a m a ng d a g a t
halaya	h a l a y a
halimbawa	h a l i m b a w a
halinghing	h a l i ng h i ng
halintularan	h a l i n t u l a r a n
halo	h a l o
halong	h a l o ng
halos	h a l o s
halumigmig	h a l u m i g m i
hamak	h a m a k
hamog	h a m o g
hamon	h a m o n
hamon-hamon	h a m o n h a m o n
hamonado	h a m o n a d o
hampas	h a m p a s
hanapin	h a n a p i n
handa	h a n d a q
handang	h a n d a ng
handog	h a n d o g
hangaan	h a ng g a q a n
hangang	h a ng g a ng
hangarin	h a ng a r i n
hangaring	h a ng a r i ng
hangga	h a ng g a
hangga't	h a ng g a t
hanggan	h a ng g a n
hanggang	h a ng g a ng
hangin	h a ng i n
hapdi	h a p t i q
hapo	h a p o
hapo-hapo	h a p o h a p u
hapon	h a p o n
hapon-hapon	h a p o n h a p u n
hapones	h a p o n e s
hapong	h a p o ng
hapunan	h a p u n a n
hapunan-hapunan	h a p u n a n h a p u n a n
harap	h a r a p
harapan	h a r a p a n
hari	h a r i
harina	h a r i n a
haring	h a r i ng
harold	h a r o l d
harrypotter	h a r i p a t e r
harvey	h a r v i
hatid-pangako	h a t i d p a ng a k o
hatiin	h a t i q i n
hatinggabi	h a t i ng g a b i
have	h a v
hawaii	h a w a q i i q
hawak	h a w a k
hay	h ay
hayaang	h a y a ng a ng
hayop	h a y u p
hazel	h a z e l
head	h e d
healthy	h e l th i
heart	h e er t
hepatitis	h ey p a t i t i s
hepe	h ey p i
heritage	h e r i t e jh
hesukristo	h e s u k r i s t o
heto	h e t o
hibashi	h i b a sh i
hibashi'y	h i b a sh i
higanteng	h i g a n t e ng
high	h ay
highlands	h ay l a n d s
higit	h i g i t
higpit	h i g p i t
hihintayin	h i h i n t a y i n
hikain	h i k a q i n
hikayat	h i k a y a t
hike	h i k
hila	h i l a
hilaga	h i l a g a
hilaw	h i l aw
hilig	h i l i g
hiling	h i l i ng
hills	h i l s
hilton	h i l t o n
himagsikan	h i m a g s i k a n
himaksikan	h i m a g s i k a n
himpapawid	h i m p a p a w i d
himutok	h i m u t o k
hinaan	h i n a q a n
hinagpis	h i n a g p i s
hinahamon	h i n a h a m o n
hinahanap	h i n a h a n a p
hinahangaan	h i n a h a ng a q a n
hinahawakan	h i n a h a w a k a n
hinaing	h i n a q i ng
hinalang	h i n a l a ng
hinampas	h i n a m p a s
hinanap	h i n a n a p
hinanapan	h i n a n a p a n
hinango	h i n a ng o
hinayang	h i n a y a ng
hinde	h i n d e
hindi	h i n d i q
hineteng	h i n e t i ng
hingang	h i ng a ng
hinigitan	h i n i g i t a n
hinihikayat	h i n i h i k a y a t
hinihiling	h i n i h i l i ng
hinihingal	h i n i h i ng a l
hinihingi	h i n i h i ng i q
hiniling	h i n i l i ng
hinimok	h i n i m o k
hiningal	h i n i ng a l
hinipo	h i n i p o
hiniram	h i n i r a m
hinlalaki	h i n l a l a k i
hinlalato	h i n l a l a t o
hinliliit	h i n l i l i q i t
hinog	h i n o g
hintayin	h i n t a y i n
hintuturo	h i n t u t u r o
hinuhuli	h i n u h u l i q
hinulugang	h i n u l u g a ng
hinurno	h i n u r n o
hipag	h i p a g
hirap	h i r a p
hirap-hirap	h i r a p h i r a p
hita	h i t a
hiv	h i v
hiya	h i y a
hk	h k
ho	h o
hoarding	h ow a er d i ng
hobby	h a b i
holdap	h ow l d a p
holdings	h ow l d i ng s
holiday	h a l i d ey
home	h o m e
hong	h o ng
hopia	h o p i y a
horizon	h o r ay z o n
hormonal	h o r m u n a l
hospitals	h o s p i t a l s
hotel	h ow t e l
hotmeal	h ow t m e a l
hour	h aw r
house	h aw s
housing	h aw s i ng
hovercraft	h a v er k r a f t
howard	h a w a er d
hoy	h oy
htwoo	h t w u
hudyat	h u jh a t
huhulihin	h u h u l i h i n
hukay	h u k ay
huli	h u l i q
huli-huli	h u l i h u l i q
huling	h u l i ng
hulyo	h u ly o q
humahamon	h u m a h a m o n
humalik	h u m a l i k
humanay	h u m a n ay
humanga	h u m a ng a
humataw	h u m a t aw
humawak	h u m a w a k
huminga	h u m i ng a
humingi	h u m i ng i q
hundred	h u n d r e d
hungkag	h u ng k a g
hunyo	h u n y o
husay	h u s ay
huwag	h u w a g
huwang	h u w a g
huwebes	h w e b e t
huweteng	h w e t i ng
hwag	h w a g
hyatt	h a y a t
hydro-gel	h y d r o jh e l
i	i
i-check	q i q ch e k
i-meet	q i q m i t
iayos	i q a y o s
iba	q i b a
iba't	q i b a t
iba't-ibang	q i b a t q i b a ng
ibabad	q i b a b a d
ibabang	q i b a b a ng
ibabaw	q i b a b aw
ibang	q i b a ng
ibayong	q i b a y o ng
ibibigay	q i b i b i g ay
ibig	q i b i g
ibigay	q i b i g ay
ibinaba	q i b i n a b a
ibinalita	q i b i n a l i t a q
ibinasura	q i b i n a s u r a
ibinibigay	q i b i n i b i g ay
ibinigay	q i b i n i g ay
ibinili	q i b i n i l i q
ibon	q i b o n
ibong	q i b o ng
icc	q i s i s i
ictsi	k t s i
id	i d
ideya	i d i a
ididiskwalipika	i d i d i s k w a l i p i k a
idila	i d i l a
idinagdag	i d i n a g d a g
idinaos	i d i n a q o s
ifc	i f s i
igalang	q i g a l a ng
igiit	i g i q i t
iginiit	i g i n i q i t
iginugugol	i g i n u g u g o l
ignacio	i g n a sh o
igugol	q i g u g o l
iguhit	q i g u h i t
igupo	q i g u p u
ihahayag	i h a h a y a g
ihanda	i h a n d a
ihi	q i h i q
ihinto	i h i n t o
iigi	q i q i g i
iinspeksyunin	i q i n s p e k sh u n a n
ika	q i k a
ika'y	q i k ay
ika-anim	i k a q a n i m
ika-apat	i k a q a p a t
ika-sandaang	q i k a s a n d a q a ng
ikaanim	q i k a q a n i m
ikaanimnapung	q i k a q a n i m n a p u ng
ikaapat	q i k a q a p a t
ikaapatnapung	q i k a q a p a t n a p u ng
ikabahala	q i k a b a h a l a
ikabubuhay	q i k a b u b u h ay
ikadalawampu	q i k a d a l a w a m p u
ikadalawampu't	q i k a d a l a w a m p u t
ikadalawampung	q i k a d a l a w a m p u ng
ikadalawang	q i k a d a l a w a ng
ikalabimpito	i k a l a b i m p i t o
ikalabimpitong	i k a l a b i m p i t o ng
ikalabindalawa	i k a l a b i n d a l a w a
ikalabindalawang	i k a l a b i n d a l a w a ng
ikalabing	i k a l a b i ng
ikalabing-anim	i k a l a b i ng q a n i m
ikalabing-apat	i k a l a b i ng q a p a t
ikalabing-isa	i k a l a b i ng q i s a
ikalabing-isang	i k a l a b i ng q i s a ng
ikalabingwalo	i k a l a b i ng w a l o
ikalabingwalong	i k a l a b i ng w a l o
ikalabinlima	i k a l a b i n l i m a
ikalabinlimang	i k a l a b i n l i m a ng
ikalabinsiyam	i k a l a b i n s i y a m
ikalabintatlo	i k a l a b i n t a t l o
ikalabintatlong	i k a l a b i n t a t l o ng
ikalawa	i k a l a w a
ikalawang	i k a l a w a ng
ikalima	i k a l i m a
ikalimampung	i k a l a m a m p u ng
ikalimang	i k a l i m a ng
ikamatay	q i k a m a t ay
ikapito	q i k a p i t o
ikapitong	q i k a p i t o ng
ikapitumpung	q i k a p i t u m p u ng
ikasampu	i k a s a m p u
ikasampung	i k a s a m p u ng
ikasiyam	i k a s i y a m
ikasiyamnapung	i k a sh a m n a p u ng
ikatatlo	q i k a t a t l o
ikatatlong	q i k a t a t l o ng
ikatatlumpu	q i k a t a t l u m p u
ikatatlumpu't	q i k a t a t l u m p u t
ikatatlumpung	q i k a t a t l u m p u ng
ikatlo	q i k a t l o
ikatlong	q i k a t l o ng
ikaw	q i k aw
ikaw'y	q i k ay
ikawalo	q i k a w a l o
ikawalong	q i k a w a l o ng
ikawalumpung	q i k a w a l u m p u ng
ikinabahala	q i k i n a b a h a l a
ikinabigla	q i k i n a b i g l a
ikinabubuhay	q i k i n a b u b u h ay
ikinagagalak	q i k i n a g a g a l a k
ikinalat	q i k i n a l a t
ikinalulugod	q i k i n a l u l u g u d
ikinalulungkot	q i k i n a l u l u ng k o t
ikinamatay	q i k i n a m a t ay
ikinapilay	q i k i n a p i l ay
ikinarapa	q i k i n a r a p a
ikinararangal	q i k i n a r a r a ng a l
ikinasugat	q i k i n a s u g a t
ikinatuwa	q i k i n a t u w a
ikinulong	q i k i n u l o ng
ikinuwento	q i k i n u w e n t o
ikukumpara	q i k u k u m p a r a
ikukuwento	q i k u k u w e n t o
ikulong	q i k u l o ng
ikuwento	q i k w e n t o
ilabas	q i l a b a s
ilagan	q i l a g a n
ilagay	q i l a g ay
ilakas	q i l a k a s
ilalaan	q i l a l a q a n
ilalagak	q i l a l a g a k
ilalim	q i l a l i m
ilan	q i l a n
ilang	q i l a ng
ilapit	q i l a p i t
ilarawan	q i l a r a w a n
ilaw	q i l aw
ilawang	q i l a w a ng
ilayo	q i l a y u q
ilocos	q i l o k o s
ilog	q i l o g
iloilo	q i l o q i l o
ilong	q i l o ng
ilulunsad	q i l u l u n s a d
iluluwa	q i l u l u w a
ilunsad	q i l u n s a d
imbalance	i m b a l a n s
imbalances	i m b a l a n s e s
imbes	i m b e s
iminulat	i n i m u l a t
iminungkahi	i m i n u ng k a h i q
iminungkahing	i m i n u ng k a h i ng
impeksyon	i m p e k sh o n
impormasyon	i m p o er m a sh o n
importanteng	i m p o r t a n t i ng
importasyon	i m p o r t a sh u n
imprastraktura	i m p r a s t r a k t u r a
imprastruktura	i m p r a s t r u k t u r a
imumulat	i m u m u l a t
in	q i n
ina	q i n a
inaabangan	q i n a q a b a ng a n
inaanak	q i n a q a n a k
inaani	q i n a q a n i
inaaral	q i n a q a r a l
inaaruga	q i n a q a r u g a q
inaasahan	q i n a q a s a h a n
inaasahang	q i n a q a s a h a ng
inadobo	q i n a d o b o
inalis	q i n a l i s
inamuki	q i n a m u k i
inang	q i n a ng
inanyayahan	q i n a ny a y a h a n
inaprubahan	q i n a p r u b a h a n
inatake	q i n a t a k
inatasan	q i n a t a s a n
inatawag	q i n a t a w a g
inay	q i n ay
inc	q i n k
incorporated	q i n k o er p er ey t d
independent	q i n d e p e n d e n t
index	q i n d e k s
india	q i n d i y a
indigenous	q i n d i jh e n aw s
indonesia	q i n d o n e s i y a
industrial	q i n d u s t r a y a er
industriya	q i n d u s t r i y a
industry	q i n d u s t r i
infection	q i n f e k sh uh n
inferiority	q i n f er i y o er i t i
inflation	q i n f l ey sh uh n
inflows	q i n f l ow s
infrastructure	q i n f er a s t r u k ch o er
ingat	i ng a t
ingatan	i ng a t a n
ingay	q i ng ay
inglatera	q i ng g l a t e r a
ingles	q i ng g l e s
iniabot	q i n i q a b u t
iniahon	q i n i q a h o n
inibig	q i n i b i g
inidoro	q i n i d o r o
inihahanda	q i n i h a h a n d a
inihalo't	q i n i h a l o t
inihaw	q i n i h aw
inihawa	q i n i h a w a
inihayag	q i n i h a y a g
iniingatang	q i n i i ng a t a ng
iniinom	q i n i q i n o m
inilaan	q i n i l a q a n
inilagak	q i n i l a g a k
inilalaan	q i n i l a l a q a n
inilathala	q i n i l a t h a l a
inilawan	q i n i l a w a n
inilubog	q i n i l o b u g
inilunsad	q i n i l u n s a d
ininom	q i n i n o m
inirekomenda	q i n e r e k o m e n d a
init	q i n i t
inn	q i n
insekto	q i n s e k t o
insidente	q i n s i d e n t i
insik	q i n ch i k
intercontinental	q i n t er k ao n t i n e n t a l
interes	q i n t er e s
interesadong	q i n t e er e s a d o ng
interest	q i n t er e s t
internal	q i n t er n a l
international	q i n t er n a sh u n a l
internet	q i n t er n e t
intindihin	q i n t i n d i h i n
intramuros	q i n t r a m u r o s
intsik	q i n ch i k
inumin	q i n u m i n
inutang	q i n u t a ng
inutusan	q i n u t u s a n
inuubo	q i n u q u b o
inuumang	q i n u q u m a ng
investment	i n v e s t m e n t
investments	i n v e s t m e n t s
investors	i n v e s t o er s
inyo	q i ny o
inyogn	q i ny o g n
inyong	q i ny o ng
ipaalam	q i p a q a l a m
ipagagalaw	q i p a g a g a l aw
ipagbebenta	q i p a g b e b e n t a
ipagbili	q i p a g b i l i q
ipaglaban	q i p a g l a b a n
ipagpag	q i p a g p a g
ipagpalit	q i p a g p a l i t
ipagpapatuloy	p i n a g p a p a t u l oy
ipagpaumanhin	q i p a g p a q u m a n h i n
ipahati	q i p a h a t i
ipahayag	q i p a h a y a g
ipakilala	q i p a k i l a l a
ipaliwanag	q i p a l i w a n a g
ipamimigay	q i p a m i m i g ay
ipangako	q i p a ng a k o q
ipapasok	q i p a p a s o k
ipapatayo	q i p a p a t a y o q
ipapautang	q i p a p a q u t a ng
iparating	q i p a r a t i ng
ipasa	q i p a s a
ipasok	q i p a s o k
ipatupad	q i p a t u p a d
ipikit	i p i k i t
ipinaalam	i p i n a a l a m
ipinadala	i p i n a d a l a
ipinagbabawal	i p i n a g b a b a w a l
ipinagmalaki	i p i n a g m a l a k i
ipinahayag	i p i n a h a y a g
ipinailalim	i p i n a q i l a l i m
ipinaliwanag	i p i n a l i w a n a g
ipinamalas	i p i n a m a l a s
ipinamalita	i p i n a m a l i t a
ipinamamalita	i p i n a m a m a l i t a
ipinangako	i p i n a ng a k o
ipinangakong	i p i n a ng a k o ng
ipinanganak	i p i n a ng a n a k
ipinanganyaya	i p i n a ng a ny a y a
ipinapadala	i p i n a p a d a l a
ipinapagawa	i p i n a p a g a w a
ipinapahid	i p i n a p a h i d
ipinapanganak	i p i n a p a ng a n a k
ipinapasa	i p i n a p a s a
ipinapatupad	i p i n a p a t u p a d
ipinatong	i p i n a t u ng
ipinukol	i p i n u k o l
ipitin	q i p i t i n
ipuipo	q i p o q i p o
ipupursigi	q i p u p u r s i g i
iput-iput	q i p o t q i p t
irene	q ay r i n
ireseta	q ay r i s e t a
irigasyon	i r i g a sh u n
iringan	i r i ng a n
isa	q i s a
isa't	q i s a t
isa'y	q i s ay
isa-isa	q i s a q i s a
isaalang-alang	q i s a q a l a ng q a l a ng
isabel	q i s a b e l
isadalawatatlo	q i s a d a l a w a t a t l o
isalin	q i s a l i n
isampa	q i s a m p a
isang	q i s a ng
isara	q i s a r a
isarog	q i s a r o g
isauli	q i s a q u l i
isda	q i s d a
isdang	q i s d a ng
isinadlak	q i s i n a d l a k
isinagawang	q i s i n a g a w a ng
isinalaysay	q i s i n a l a y s ay
isinara	q i s i n a r a
isinasailalim	q i s i n a s a q i l a l i m
isinasama	q i s i n a s a m a
isinga	q i s i ng a
isiningit	q i s i n i ng i t
isinuksok	q i s i n u k s o k
isinulat	q i s i n u l a t
isip	q i s i p
isipan	q i s i p a n
isisilbing	q i s i s i l b i ng
iskedyul	q i s k e jh u l
isko	q i s k o
isla	q i s l a
island	q ay l a n
islands	q ay l a n d s
ispiritu	q i s p i r i t o
isport	q i s p o er t
isra	q i s r a
isuko	i s u k o
isulat	q i s u l a t
isuot	i s u q u t
isusulong	i s u s u l o ng
isyu	i sh u
itaas	i t a q a s
itago	i t a g o q
itanim	i t a n i m
itapon	i t a p o n
itataas	i t a t a q a s
itatanong	i t a t a n o ng
itatapon	i t a t a p o n
itatayo	i t a t a y o q
itay	i t ay
itigil	i t i g i l
itiklop	i t i k l o p
itim	i t i m
itinaas	i t i n a q a s
itinadhana	i t i n a d h a n a
itinakdang	i t i n a k d a ng
itinakwil	i t i n a k w i l
itinanghal	i t i n a ng h a l
itinanim	i t i n a n i m
itinapat	i t i n a p a t
itinapon	i t i n a p o n
itinatanim	i t i n a t a n i m
itinusok	i t i n u s o k
itinuturing	i t i n u t u r i ng
itinuturo	i t i n u t u r o
ititigil	i t i t i g i l
itlog	i t l o g
ito	i t o
ito'y	i t oy
itong	i t o ng
ituloy	i t u l oy
ituon	i t o q o n
itutuloy	i t u t u l oy
ivan	i v a n
iwaksi	q i w a k s i
iwas	q i w a s
iwasan	q i w a s a n
iwasang	q i w a s a ng
iyan	q i y a n
iyang	q i y a ng
iyo	q i y o q
iyon	q i y o n
iyong	q i y o ng
iyung	q i y o ng
j	jh
james	jh ey m s
jan	jh a n
jane	jh ey n
janice	jh a n i s
janus	jh a n u s
japan	jh a p a n
jasmin	jh a z m i n
jay	jh ey
jayson	jh ey s o n
jc	jh ey s i
jean	jh i n
jeep	jh e p
jeepney	jh e p n i
jeff	jh e f
jeffrey	jh e f er i
jem	jh e m
jennifer	jh e n e f e r
jess	jh e s
jessa	jh e s a
jestoni	jh i s t ow n i
jesus	h i s u s
jg	jh ey jh i
jillian	jh i ly a n
jinky	jh i n k i
jm	jh m
joan	jh o q a n
joaquin	h u q a k i n
jocelyn	jh o s e ly n
joel	j o w e l
john	jh ao n
jolina	jh o l i n a
jollibee	jh ao l i b i
jonathan	jh o n a th a n
jose	jh o s e
joseph	jh o s e f
josephine	jh o s e f i n
joy	jh oy
jp	jh p
jr	jh er
juan	h u w a n
julian	jh u ly a n
julius	jh u ly u s
juniior	jh u n i q i o r
junior	jh u ny o r
just	jh a s t
ka	k a
kaagad	k a q a g a d
kaakibat	k a q a k i b a t
kaakit-akit	k a q a k i t q a k i t
kaalaman	k a q a l a m a n
kaalipinan	k a q a l i p i n a n
kaalipustaan	k a q a l i p u s t a q a n
kaanak	k a q a n a k
kaarawan	k a q a r a w a n
kaasalan	k a q a s a l a n
kaawa-awa	k a q a w a q a w a
kaawa-awa't	k a q a w a q a w a t
kaaway	k a q a w ay
kababayan	k a b a b a y a n
kababayang	k a b a b a y a ng
kabagay	k a b a g ay
kaban	k a b a n
kabangisan	k a b a ng i s a n
kabarkada	k a b a r k a d a
kabaro	k a b a r o
kabayan	k a b a y a n
kabayo	k a b a y o q
kabihasnan	k a b i h a s n a n
kabihasnang	k a b i h a s n a ng
kabila	k a b i l a
kabilihan	k a b i l i h a n
kabinet	k a b i n e t
kabit	k a b i t
kabubuwal	k a b u b u w a l
kabuhayan	k a b u h a y a n
kabundukan	k a b u n d u k a n
kabute	k a b u t i
kabutihan	k a b u t i h a n
kabutihang	k a b u t i h a ng
kabuuang	k a b u q u q a ng
kada	k a d a
kadalasang	k a d a l a s ang
kadayukdukan	k a d a y u k d u k a n
kagabi	k a g a b i
kagalang-galang	k a g a l a ng q g a l a ng
kagalingan	k a g a l i ng a n
kagalit	k a g a l i t
kagamitan	k a g a m i t a n
kagandahang	k a g a n d a h a ng
kagatin	k a g a t i n
kagawaran	k a g a w a r a n
kagila-gilalas	k a g i l a g i l a l a s
kaginhawaaan	k a g i n h a w a q a q a n
kaginhawaan	k a g i n h a w a q a n
kaginhawahan	k a g i n h a w a h a n
kaginhawahang	k a g i n h a w a h a ng
kagipitan	k a g i p i t a n
kagitna	k a g i t n a
kagubatan	k a g u b a t a n
kagusutan	k a g u s u t a n
kahabaan	k a h a b a q a n
kahandaang	k a h a n d a q a ng
kahanga-hanga	k a h a ng a h a ng g a
kahapon	k a h a p o n
kaharap	k a h a r a p
kaharian	k a h a r i q a n
kaharutan	k a h a r u t a n
kahatulan	k a h a t u l a n
kahawig	k a h a w i g
kahel	k a h e l
kahilingan	k a h i l i ng a n
kahirap	k a h i r a p
kahirapan	k a h i r a p a n
kahit	k a h i t
kahon	k a h o n
kahoy	k a h oy
kahulugan	k a h u l u g a n
kaibigan	k a q i b i g a n
kaiklian	k a q i k l i q a n
kailan	k a q i l a n
kailangan	k a q i l a ng a n
kailangang	k a q i l a ng a ng
kailanman	k ay l a n m a n
kailngan	k ey l ng a n
kain	k a q i n
kaina	k a q i n a
kainan	k a q i n a n
kainang	k a q i n a ng
kainin	k a q i n i n
kaisipan	k a q i s i p a n
kaka	k a k a
kaka-kaka	k a k a k a k a q
kakagatin	k a k a g a t i n
kakain	k a k a q i n
kakainin	k a k a q i n i n
kakambal	k a k a m b a l
kakampi	k a k a m p i
kakanta	k a k a n t a
kakapusan	k a k a p u s a n
kakarekord	k a k a r e k o er d
kakasya	k a k a sh a
kakaunti	k a k a q u n t i
kakayahan	k a k a y a h a n
kaki	k a k i
kakilala	k a k i l a l a
kaklase	k a k l a s i
kakulangan	k a k u l a ng a n
kakulungan	k a k u l u ng a n
kalaban	k a l a b a n
kalabaw	k a l a b aw
kalagayan	k a l a g a y a n
kalaguyo	k a l a g u y o q
kalahati	k a l a h a t i
kalahating	k a l a h a t i ng
kalakal	k a l a k a l
kalakalan	k a l a k a l a n
kalalagayan	k a l a l a g a y a n
kalalakihan	k a l a l a k i h a n
kalamnan	k a l a m n a n
kalang	k a l a ng
kalaro	k a l a r o
kalat	k a l a t
kalaunan	k a l a q u n a n
kalawang	k a l a w a ng
kalayaan	k a l a y a q a n
kalbo	k a l b o
kaldereta	k a l d i r i t a
kalibo	k a l i b o
kalimitang	k a l i m i t a ng
kalimutan	k a l i m u t a n
kalinanga'y	k a l i n a ng a y
kalinawan	k a l i n a w a n
kalinga	k a l i ng a
kalingkingan	k a l i ng k i ng a n
kalipad	k a l i p a d
kalipunan	k a l i p u n a n
kaliwa	k a l i w a
kaliwang	k a l i w a ng
kaloob	k a l o q o b
kalooban	k a l o q o b a n
kalupitan	k a l u p i t a n
kalusan	k a l u s a n
kalusugan	k a l u s u g a n
kalye	k a l y e
kalyeng	k a l y e ng
kamag-anak	k a m a g q a n a k
kamakailan	k a m a k ay l a n
kamakalawa	k a m a k a l a w a
kamakatlo	k a m a k a t l o
kamang	k a m a ng
kamao	k a m a q o
kamatayan	k a m a t a y a n
kamatayang	k a m a t a y a ng
kamatis	k a m a t i s
kamay	k a m a y
kambal	k a m b a l
kambing	k a m b i ng
kami	k a m i
kaming	k a m i ng
kamo	k a m o
kampana	k a m p a n a q
kampante	k a m p a n t e
kampanya	k a m p a ny a
kamulalaan	k a m u l a l a q a n
kanan	k a n a n
kanang	k a n a ng
kandidato	k a n d i d a t o
kang	k a ng
kani	k a n i
kani-kanilang	k a n i q k a n i l a ng
kani-kanino	k a n i q k a n i n o
kani-kaniyang	k a n i q k a n i y a ng
kanila	k a n i l a
kanila'y	k a n i l ay
kanilang	k a n i l a ng
kanin	k a n i n
kanina	k a n i n a
kaninang	k a n i n a ng
kanino	k a n i n o
kaniya	k a n i y a
kaniyang	k a n i y a ng
kanser	k a n s e er
kanto	k a n t o
kanya	k a ny a
kanyang	k a ny a ng
kapag	k a p a g
kapagdaka	k a p a g d a k a q
kapagka	k a p a g k a
kapaitan	k a p a q i t a n
kapaligiran	k a p a l i g i r a n
kapalitan	k a p a l i t a n
kapamilya	k a p a m i ly a
kapanatagan	k a p a n a t a g a n
kapangakuan	k a p a ng a k u q a n
kapangyarihang	k a p a ng a y a r i h a ng
kaparehong	k a p a r e h o ng
kapatagan	k a p a t a g a n
kapatid	k a p a t i d
kapayapaan	k a p a y a p a q a n
kape	k a p e
kapighatian	k a p i g h a t i q a n
kapis	k a p i s
kapisanan	k a p i s a n a n
kapit-bayan	k a p i t b a y a n
kapitalista	k a p i t a l i s t a
kapitbahay	k a p i t b a h ay
kapuluan	k a p u l u q a n
kapuluang	k a p u l u a ng
kapupunan	k a p u p u n a n
kapurihan	k a p u r i h a n
kapuso	k a p u s o q
kaputol	k a p u t o l
kapuwa	k a p w a
kapwa	k a p w a
karagatan	k a r a g a t a n
karagdagan	k a r a g d a g a n
karagdagang	k a r a g d a g a ng
karaingan	k a r a i ng a n
karaka	k a r a k a q
karakaraka	k a r a k a r a k a q
karakarakang	k a r a k a r a k a ng
karamay	k a r a m ay
karamihan	k a r a m i h a n
karanasan	k a r a ny a s a n
karangalan	k a r a ng a l a n
karangyaan	k a r a ng y a q a n
karaniwan	k a r a n i w a n
karapatan	k a r a p a t a n
karayom	k a r a y o m
karayon	k a r a y o n
kare-kare	k a r e k a r e
karen	k a r e n
karlo	k a r l o
karne	k a r n
karneng	k a r n e ng
kasabay	k a s a b ay
kasabihan	k a s a b i h a n
kasaganaan	k a s a g a n a q a n
kasagutan	k a s a g u t a n
kasakiman	k a s a k i m a n
kasal	k a s a l
kasalanan	k a s a l a n a n
kasalatan	k a s a l a t a n
kasali	k a s a l i q
kasalukuyan	k a s a l u k u y a n
kasalukuyang	k a s a l u k u y a ng
kasama	k a s a m a
kasamaan	k a s a m a q a n
kasamahan	k a s a m a h a n
kasamang	k a s a m a ng
kasambahay	k a s a m b a h ay
kasauluyang	k a s a q u l u y a ng
kasaysayan	k a s a y s a y a n
kasi	k a s i
kasiglahan	k a s i g l a h a n
kasintahan	k a s i n t a h a n
kasiyahan	k a s i y a h a n
kaso	k a s o
kasoy	k a s oy
kassen	k a s e n
kastanyog	k a s t a ny o g
kastila	k a s t i l a
kastilang	k a s t i l a ng
kasukasuan	k a s u k a s u q a n
kasukat	k a s u k a t
kasulatan	k a s u l a t a n
kasundo	k a s u n d o
kasunduang	k a s u n d u q a ng
kasunod	k a s u n o d
kasuy	k a s u y
kat	k a t
kataas	k a t a q a s
katabi	k a t a b i q
katagal	k a t a g a l
katagalugan	k a t a l g a l u g a n
katahimikan	k a t a h i m i k a n
kataksilan	k a t a k s i l a n
katalasan	k a t a l a s a n
katalik	k a t a l i k
katalinuhan	k a t a l i n u h a n
katam-is	k a t a m q i s
katambal	k a t a m b a l
katamisan	k a t a m i s a n
katamtamang	k a t a m t a m a ng
katanghaliang-tapat	k a t a ng h a l i q a ng t a p a t
katangiang	k a t a ng i q a ng
katapangan	k a t a p a ng a n
katapat	k a t a p a t
katapusan	k a t a p u s a n
katapusang	k a t a p u s a ng
katawan	k a t a w a n
kate	k ey t
katipunan	k a t i p u n a n
katiwalian	k a t i w a l i q a n
katotohanan	k a t u t u h a n a n
katotohanang	k a t u t u h a n a ng
katrina	k a t er i n a
katukayo	k a t u k a y o q
katulad	k a t u l a d
katulong	k a t u l u ng
katumbas	k a t u m b a s
katunayan	k a t u n a y a n
katunggali	k a t u ng g a l i q
katuparan	k a t u p a r a n
katutubo	k a t u t u b o q
katuwang	k a t u w a ng
katuwiran	k a t w i r a n
kaugalian	k a q u g a l i q a n
kaugaliang	k a q u g a l i q a ng
kaugnay	k a q u g n a y
kaugnayan	k a q u g n a y a n
kaukulang	k a q u k u l a ng
kaulayaw	k a q u l a y aw
kauna-unahang	k a q u n a q u n a h a ng
kaunlara't	k a q u n l a r a t
kaunting	k a q u n t i ng
kausap	k a q u s a p
kausapin	k a q u s a p i n
kautusan	k a q u t u s a n
kawal	k a w a l
kawal-amerikanong	k a w a l q a m e r i k a n o ng
kawalan	k a w a l a n
kawalang-hanggan	k a w a l a ng h a ng g a n
kawili-wili	k a w i l i q w i l i q
kawilihan	k a w i l i h a n
kay	k ay
kaya	k a y a
kaya't	k a y a t
kaya'y	k a y ay
kaya-kaya	k a y a k a y a
kayang	k a y a ng
kayat	k a y a t
kayo	k a y o q
kayong	k a y o ng
kaysa	k a y s a
keep	k e p
kennon	k e n o n
kesong	k e s o ng
ketoconazole	k e t o k o n a z o l
khalid	k h a l i d
kibo	k i b o
kidlat	k i d l a t
kiko	k i k o
kilabot	k i l a b o t
kilala	k i l a l a
kilala't	k i l a l a t
kilalang	k i l a l a ng
kilalanin	k i l a l a n i n
kilawin	k i l a w i n
kilay	k i l ay
kili-kili	k i l i q k i l i q
kilikili	k i l i k i l i q
kilo	k i l o q
kilogram	k i l o g r a m
kilos	k i l o s
kim	k i m
kina	k i n a
kinaaawaan	k i n a q a w a q a n
kinaawaan	k i n a a w a q a n
kinabukasan	k i n a b u k a s a n
kinagabihan	k i n a g a b i h a n
kinahiratihang	k i n a h i r a t i h a ng
kinain	k i n a q i n
kinakailangan	k i n a k ay l a ng a n
kinakapatid	k i n a k a p a t i d
kinakasama	k i n a k a s a m a
kinakausap	k i n a k a q u s a p
kinakitaan	k i n a k i t a q a n
kinalalagyan	k i n a l a l a g y a n
kinalaman	k i n a l a m a n
kinalulugdan	k i n a l u l u g d a n
kinaumagahan	k i n a q u m a g a h a n
kinauukulan	k i n a q u q u k u l a n
kinikita	k i n i k i t a
kinilaw	k i n i l aw
kinuha	k i n u h a
kirot	k i r u t
kisig	k i s i g
kita	k i t a
kita-kita-kita	k i t a k i t a k i t a q
kitchen	k i ch e n
kitikiti	k i t i k i t i
klase	k l a s i
klenk	k l i ng k
klima	k l i m a
knapsack	k n a p s a k
ko	k o
ko'y	k oy
kobunsha	k o b u n s h a q
kokak	k o k a k
koleksyon	k o l e k sh uh n
kolektahin	k o l e k t a h i n
kombinasyon	k o m b i n a sh y u n
komedi	k u m i d i
kompanya	k o m p a ny a
kompanyang	k uh m p a ny a ng
kondisyon	k u n d i sh u n
kong	k o ng
kongresman	k o ng g r e s m a n
konstruksyon	k o n s t r u k sh o n
kontra	k o n t r a
kontrata	k o n t r a t a
kontrobersyal	k o n t r o b e er sh a l
kopyahin	k o p y a h i n
korte	k o r t i
kow	k ow
kriminal	k r i m i n a l
krisis	k r i s i s
kristiyanismo	k r i s ch a n i s m o
krudo	k r u d o
krus	k r u s
kubo	k u b o q
kudarat	k u d a r a t
kuhanin	k u h a n i n
kuko	k u k o
kukong	k u k o ng
kulang	k u l a ng
kulay	k u l ay
kulayan	k u l a y a n
kulelat	k u l i l a t
kulo	k u l o
kulog	k u l o g
kulturang	k u l t u r a ng
kumain	k u m a q i n
kumakain	k u m a g k a q i n
kumakapit	k u m a k a p i t
kumakatawan	k u m a k a t a w a n
kumalat	k u m a l a t
kumanta	k u m a n t a
kumare	k u m a r e
kumawala	k u m a w a l a q
kumibo	k u m i b o
kumikilos	k u m i k i l o s
kumilos	k u m i l o s
kumita	k u m i t a
kumot	k u m o t
kumpanya	k u m p a ny a
kumpara	k u m p a r a
kumpare	k u m p a r e
kumpiyansa	k o m p y a n s a
kumpleto	k u m p l e t o
kumpletuhin	k u m p l e t u h i n
kumuha	k u m u h a q
kumukulong	k u m u k u l o ng
kumusta	k u m u s t a
kundi	k u n d i q
kung	k o ng
kunin	k u n i n
kunwa'y	k u n w ay
kunwaring	k u n w a r i ng
kuru-kuro	k o r o k u r o
kuryente	k u r y e n t e
kusa	k u s a
kusang	k u s a ng
kusina	k u s i n a
kuto	k u t o
kutob	k u t u b
kutsinta	k u ch i n t a q
kutson	k u t s o n
kuwaiti	k u w ey t i q
kuwelyo	k u w e ly o q
kuwento	k u w e n t o
kuwento'y	k u w e n t oy
kuwentong	k u w e n t o ng
kuya	k u y a
kuyukot	k u y u k o t
kwaderno	k w a d e r n o
kwadernong	k w a d e r n o ng
kwento	k w e n t o
la	l a
la-ang	l a q a ng
laban	l a b a n
labanan	l a b a n a n
labas	l a b a s
labasan	l a b a s a n
labi	l a b i
labi-labi	l a b i l a b I q
labindalawang	l a b i n d a l a w a ng
labing	l a b i ng
labing-anim	l a b i ng q a n i m
labing-apat	l a b i ng q a p a t
labing-isa	l a b i ng q i s a
labing-isang	l a b i ng q i s a ng
labing-limang	l a b i ng q l i m a ng
labingdalawa	l a b i ng d a l a w a
labinglima	l a b i ng l i m a
labingpito	l a b i ng p i t o
labingsiyam	l a b i ng s i y a m
labingtatlo	l a b i ng t a t l o
labingwalo	l a b i ng w a l o
labinlimang	l a b i n l i m a ng
labintatlong	l a b i n t a t l o ng
labis	l a b i s
labor	l a b o r
lacdang	l a k d a ng
lagapak	l a g a p a k
lagayan	l a g a y a n
lagi	l a g i
laging	l a g i ng
lagnat	l a g n a t
lagot	l a g u t
lagpas	l a g p a s
laguna	l a g u n a
lagyan	l a g y a n
lahat	l a h a t
lahi	l a h i
lahing	l a h i ng
laing	l a q i ng
lakad	l a k a d
lakarin	l a k a r i n
lakas	l a k a s
lakasan	l a k a s a n
lake	l a k i
laking	l a k i ng
lala-lala	l a l a q l a l a q
lalabas	l a l a b a s
lalagdaan	l a l a g d a q a n
lalago	l a l a g o q
lalagyan	l a l a g y a n
lalagyang	l a l a g y a ng
lalakas	l a l a k a s
lalake	l a l a k i
lalakeng	l a l a k i ng
lalaki	l a l a k i
lalaking	l a l a k i ng
lalamunan	l a l a m u n a n
lalapit	l a l a p i t
lalawigan	l a l a w i g a n
lalawigang	l a l a w i g a ng
lalayo	l a l a y o q
lalo	l a l o
lalo't	l a l o t
lalong	l a l o ng
lalu	l a l o
laluna	l a l u n a
lalung	l a l o ng
lalung-lalo	l a l o ng q l a l o
laman	l a m a n
lamang	l a m a ng
lamesa	l a m e s a
lamig	l a m i g
lamitan	l a m i t a n
lamok	l a m o k
lancaster	l a n k a s t e r
land	l a n d
landas	l a n d a s
lane	l ey n
lang	l a ng
langaw	l a ng aw
langgam	l a ng g a m
langis	l a ng i s
langit	l a ng i t
laoag	l a w a g
laon	l a q o n
lapis	l a p i s
lapu-lapu	l a p u l a p u
larangan	l a r a ng a n
larawan	l a r a w a n
larawang	l a r a w a ng
laruan	l a r u q a n
las	l a s
lasa	l a s a
lasang	l a s ang
lasing	l a s i ng
latay	l a t ay
latin	l a t i n
lawa	l a w a
lawing	l a w i ng
laws	l a w s
layon	l a y u n
layunin	l a y u n i n
lazaro	l a z a r o
le	l e
leader	l e y a d er
leah	l e y a
leandro	ly a n d r o
lebel	l e b e l
lecaros	l e k a r u s
leche	l e ch e
lechon	l e ch o n
leeg	l e q e g
legal	l e g a l
legaspi	l e g a z p i
legazpi	l e g a z p i
legazpo	l e g a z p i
lenny	l e n i
lente	l e n t e
lepanto	l i p a n t o
lester	l e s t er
letra	l e t r a
level	l e v e l
levels	l e v e l s
lgu	l g
lgus	l g u s
liban	l i b a n
libingan	l i b i ng a n
libo	l i b o
libo't	l i b o t
libong	l i b o ng
libreng	l i b e
libro	l i b r o
librong	l i b r o ng
libu-libong	l i b o l i b o ng
lider	l i d e er
liderato	l i d e er a t o
life	l ay f
ligaw	l i g aw
ligaw-ligaw	l i g aw l i g aw
ligaya	l i g a y a
lighthouses	l ay t h aw s e s
lights	l ay t s
ligtas	l i g t a s
liha-liha	l i h a l i h a q
lihim	l i h i m
likas	l i k a s
like	l ay k
likha	l i k a
likod	l i k o d
likuran	l i k o r a n
liliban	l i l i b a n
lilim	l i l i m
lim	l i m
lima	l i m a
limampu	l i m a m p u
limampu't	l i m a m p u t
limampung	l i m a m p u ng
limang	l i m a ng
limit	l i m i t
limited	l i m i t d
limits	l i m i t s
lina	l i n a
linden	l i n d e n
lindol	l i n d o l
lingap	l i ng a p
linggo	l i ng g o q
lingo	l i ng o
linisin	l i n i s i n
link	l i n k
linya	l i ny a
lipad	l i p a d
lipat	l i p a t
lipi	l i p i q
lipuna'y	l i p u n ay
lipunan	l i p u n a n
listahan	l i s t a h a n
listed	l i s t d
litid	l i t i d
lito	l i t o
litro	l i t r o
litrong	l i t r u ng
liwanag	l i w a n a g
loan	l u q a n
local	l o k a l
locator	l o k a t o r
lokal	l o k a l
lola	l o l a
lolo	l o l o
lolobo	l o l o b o
long	l o ng
longer	l ao ng er
longganisa	l o ng g a n i s a
loob	l o q o b
los	l o s
lotilla	l o t i ly a
lotion	l ow sh o n
lotus	l o t u s
lou	l u
lovely	l uh v l i
lpg	l p g
lpgma	l p g m a
lrta	l er t a
lrtone	l er t u n
ltd	l t d
lubak	l u b a k
lubha	l u b h a q
lubos	l u b u s
lucia	l u s i y a
lugar	l u g a r
lugaw	l u g aw
luha	l u h a q
luho	l u h o
luis	l u i s
luke	l u k
lulublob	l u l u b l u b
lulunurin	l u l u n u r i n
lumabas	l u m a b a s
lumakad	l u m a k a d
lumakas	l u m a k a s
lumaking	l u m a k i ng
lumala	l u m a l a
lumalabas	l u m a l a b a s
lumalabo	l u m a l a b o
lumalakad	l u m a l a k a d
lumalaki	l u m a l a k i
lumalala	l u m a l a l a
lumalangoy	l u m a l a ng oy
lumaon	l u m a q a n
lumapit	l u m a p i t
lumbia	l u m b i y a
lumiban	l u m i b a n
lumigaya	l u m i g a y a
lumikha	l u m i k h a q
lumiligid	l u m i l i g i d
lumilipad	l u m i l i p a d
lumingon	l u m i ng o n
lumipad	l u m i p a d
lumipas	l u m i p a s
lumipat	l u m i p a t
lumitaw	l u m i t aw
lumobo	l u m o b o
lumpia	l u m p i y a
lumulutang	l u m u l u t a ng
lumuluwas	l u m u l u w a s
lumunok	l u m u n o k
lumura	l u m u r a
lunas	l u n a s
lunday	l u n d ay
lunes	l u n e s
luneta	l u n e t a
lung	l o ng
lungga	l u ng g a q
lungsod	l u ng s o d
lunok	l u n o k
luntian	l u n t i q a n
luntiang	l u n t i q a ng
lunurin	l u n u r i n
lupa	l u p a
lupaing	l u p a i ng
lupon	l u p u n
lusng	l u s
lusong	l u s o ng
lusubin	l u s u b i n
lutuan	l u t u w a n
lutui	l u t u i q
m	m
ma'am	m a q a m
ma-export	m a q e k s p o er t
ma-expose	m a q e k s p ow s
ma-screen	m a q s k r i n
maaalat	m a q a q a l a t
maaantay	m a q a q a n t ay
maaapektuhan	m a q a q a p e k t u h a n
maaaprubahan	m a q a p r u b a h a n
maaari	m a q a q a r i
maaaring	m a q a q a r i ng
maaarte	m a q a a r t e
maaasahan	m a q a q a s a h a n
maabot	m a q a b o t
maaga	m a q a g a
maagang	m a q a g a ng
maagap	m a q a g a p
maagapan	m a q a g a p a n
maalam	m a q a l a m
maalamat	m a q a l a m a t
maalimuom	m a q a l i m u q u m
maalinsangan	m a q a l i n s a ng a n
maalis	m a q a l i s
maaliwalas	m a a l i w a l a s
maalong	m a q a l o ng
maambon	m a q a m b o n
maapektuhan	m a q a p e k t u h a n
maaraw	m a q a r aw
maari	m a q a r i
maaring	m a q a r i ng
maatim	m a q a t i m
maayos	m a q a y o s
mababa	m a b a b a
mababakas	m a b a b a k a s
mababang	m a b a b a ng
mababasa	m a b a b a s a
mababaw	m a b a b aw
mababawas	m a b a b a w a s
mababawasan	m a b a b a w a s a n
mababawi	m a b a b a w i
mababayaran	m a b a b a y a r a n
mabagal	m a b a g a l
mabagal-lumakad	m a b a g a l u m a k a d
mabahala	m a b a h a l a
mabait	m a b a q i t
mabalitaan	m a b a l i t a q a n
mabasa	m a b a s a
mabasag	m a b a s a g
mabawasan	m a b a w a s a n
mabayaran	m a b a y a r a n
mabibigat	m a b i b i g a t
mabibili	m a b i b i l i q
mabigat	m a b i g a t
mabigyan	m a b i g y a n
mabigyang-daan	m a b i g y a ng d a q a n
mabili	m a b i l i q
mabilis	m a b i l i s
mabilisang	m a b i l i s a ng
mabisang	m a b i s a ng
mabubuong	m a b u b u q o ng
mabubuti	m a b u b u t i
mabubuwal	m a b u b u w a l
mabuhay	m a b u h ay
mabuntis	m a b u n t i s
mabunyag	m a b u n y a g
mabuo	m a b u q o
mabusog	m a b u s o g
mabuti	m a b u t i
mabuting	m a b u t i ng
mac	m a k
macapagal	m a k a p a g a l
macapagal-arroyo	m a k a p a g a l q a r o y o q
mactan	m a k t a n
mactan-cebu	m a k t a n s e b u
madadaan	m a d a d a q a n
madalang	m a d a l a ng
madalas	m a d a l a s
madali	m a d a l i q
madaling	m a d a l i ng
madaling-araw	m a d a l i ng q a r aw
madilim	m a d i l i m
madla	m a d l a
madrasta	m a d er a s t a
madudukot	m a d u d u k o t
mag	m a g
mag-aahon	m a g q a q a h o n
mag-aangkat	m a g q a q a ng k a t
mag-aaral	m a g q a a r a l
mag-aaway	m a g q a q a w ay
mag-abala	m a g q a b a l a
mag-aral	m a g q a r a l
mag-asawa	m a g q a s a w a
mag-asawang	m a g q a s a w a ng
mag-cell	m a g q s e l
mag-damit	m a g q d a m i t
mag-iingay	m a g q i q i ng ay
mag-ikaanim	m a g q i k a q a n i m
mag-import	m a g q i m p o er t
mag-isa	m a g q i s a
mag-isang	m a g q i s a ng
mag-linis	m a g l i n i s
mag-sara	m a g q s a r a
mag-text	m a g t e k s t
mag-uugnay	m a g q u q u g n ay
magagamot	m a g a g a m o t
magaganap	m a g a g a n a p
magaganda't	m a g a g a n d a t
magagandang	m a g a g a n d a ng
magagawa	m a g a g a w a
magalang	m a g a l a ng
magaling	m a g a l i ng
maganap	m a g a n a p
maganda	m a g a n d a
magandang	m a g a n d a ng
magandang-loob	m a g a n d a ng l o q o b
magaspang	m a g a s p a ng
magbabalik	m a g b a b a l i k
magbabayad	m a g b a b a y a d
magbanggit	m a g b a ng g i t
magbanlaw	m a g b a ng l aw
magbasa	m a g b a s a
magbayad	m a g b a y a d
magbenta	m a g b e n t a
magbibigay	m a g b i b i g ay
magbibinhi	m a g b i b i n h i
magbibiyahe	m a g b i b i y a i
magbigay	m a g b i g ay
magbilang	m a g b i l a ng
magbiro	m a g b i r o
magbubuhat	m a g b u b u h a t
magbubukas	m a g b u b u k a s
magbuhat	m a g b u h a t
magbuhos	m a g b u h o s
magbunga't	m a g b u ng a t
magdadala	m a g d a d a l a
magdadasal	m a g d a d a s a l
magdagdag	m a g d a g d a g
magdala	m a g d a l a
magdaldalan	m a g d a l d a l a n
magdamag	m a g d a m a g
magdaragdag	m a g d a r a g d a g
magdasal	m a g d a s a l
magdirikit	m a g d i r i k i t
magdiwang	m a g d i w a ng
magdudulot	m a g d u d u l o t
magellan	m e jh e l a n
maghahabulan	m a g h a h a b u l a n
maghalo	m a g h a l o
maghangad	m a g h a ng a d
maghapon	m a g h a p o n
maghapong	m a g h a p o ng
maghapunan	m a g h a p u n a n
maghari	m a g h a r i
maghubad	m a g h u b a d
maghugas	m a g h u g a s
magibgay	m a g i b g ay
magiging	m a g i g i ng
maginaw	m a g i n aw
maging	m a g i ng
magising	m a g i s i ng
magkabalikan	m a g k a b a l i k a n
magkabigkis	m a g k a b i g k i s
magkahawig	m a g k a h a w i g
magkahiwa-hiwalay	m a g k a h i w a h i w a l ay
magkaiba	m a g k a q i b a
magkaisa	m a g k a q i s a
magkaisang	m a g k a q i s a ng
magkaisang-loob	m a g k a q i s a l o q o b
magkakaanak	m a g k a k a q a n a k
magkakapatid	m a g k a k a p a t i d
magkakaroon	m a g k a k a r o q o n
magkakaruon	m a g k a k a r o q o n
magkakasunod	m a g k a k a s u n o d
magkakaugnay	m a g k a k a q u g n a y
magkano	m a g k a n o
magkaparis	m a g k a p a r e s
magkapatid	m a g k a p a t i d
magkaron	m a g k a r o n
magkaroon	m a g k a r o q o n
magkaruon	m a g k a r o q o n
magkasama	m a g k a s a m a
magkasing-tanda	m a g k a s i ng t a n d a
magkasingtulad	m a g k a s i ng t u l a d
magkatrabaho	m a g k a t r a b a h o q
magkaugnay	m a g k a q u g n a y
magkikita	m a g k i k i t a
magkita	m a g k i t a q
magkulang	m a g k u l a ng
magkupkop	m a g k u p k o p
magkuwento	m a g k w e n t o
maglabas	m a g l a b a s
maglalaan	m a g l a l a q a n
maglalabas	m a g l a l a b a s
maglalaro	m a g l a l a r o
maglaro	m a g l a r o
maglaya	m a g l a y a
maglinis	m a g l i n i s
magluto	m a g l u t o
magluwas	m a g l u w a s
magmahal	m a g m a h a l
magnanakaw	m a g n a n a k aw
magnanakaw-magnanakaw	m a g n a n a k aw q m a g n a n a k aw
magpa-beauty	m a g p a q b i y u t i
magpabili	m a g p a b i l i q
magpacheck-up	m a g p a ch e k q u p
magpadala	m a g p a d a l a
magpagod	m a g p a g o d
magpagupit	m a g p a g u p i t
magpahinga	m a g p a h i ng a
magpaiwan	m a g p a q i w a n
magpakailanman	m a g p a k ay l a n m a n
magpakatao	m a g p a k t aw
magpakonsulta	m a g p a k o n s u l t a
magpalit	m a g p a l i t
magpapahintulot	m a g p a p a h i n t u l o t
magpapalit	m a g p a p a l i t
magpapatuloy	m a g p a p a t u l oy
magpareserve	m a g p a r e s er v
magpasa	m a g p a s a
magpasalamat	m a g p a s a l a m a t
magpatingin	m a g p a t i ng i n
magpatubig	m a g p a t u b i g
magpatuloy	m a g p a t u l oy
magpatupad	m a g p a t u p a d
magpaturo	m a g p a t u r o
magpulong	m a g p u l o ng
magpulong-pulong	m a g p u l o ng p u l o ng
magpuputol	m a g p u p u t o l
magrenta	m a g r e n t a
magresulta	m a g r e s u l t a
magro-rolbak	m a g r o r o l b a k
magsabi	m a g s a b i
magsagawa	m a g s a g a w a
magsalita	m a g s a l i t a
magsama	m a g s a m a
magsama-sama	m a g s a m a q s a m a
magsanay	m a g s a n ay
magsara	m a g s a r a
magsasaka	m a g s a s a k a q
magsasaka-magsasaka	m a g s a s a k a q m a g s a s a k a q
magsasakang	m a g s a s a k a ng
magsasalita	m a g s a s a l i t a
magsasalo	m a g s a s a l o
magsasama	m a g s a s a m a
magsaya	m a g s a y a
magsikap	m a g s i k a p
magsimula	m a g s i m u l a
magsisi	m a g s i s i
magsisimula	m a g s i s i m u l a
magsitigil	m a g s i t i g i l
magsulat	m a g s u l a t
magsusulat	m a g s u s u l a t
magtago	m a g t a g o
magtagumpay	m a g t a g u m p ay
magtapon	m a g t a p o n
magtataas	m a g t a t a q a s
magtataksil	m a g t a t a k s i l
magtatayo	m a g t a t a y o q
magtayo	m a g t a y o q
magtiis	m a g t i q i s
magtingi	m a g t i ng i q
magtipon	m a g t i p o n
magtiwala	m a g t i w a l a
magtrabaho	m a g t r a b a h o q
magturo	m a g t u r o
magtutugon	m a g t u t u g o n
magtuturo	m a g t u t u r o
magugutom	m a g u g u t u m
magulang	m a g u l a ng
magulo	m a g u l o
magwatak-watak	m a g w a t a k q w a t a k
magwawasak	m a g w a w a s a k
mahaba	m a h a b a
mahabang	m a h a b a ng
mahaharot	m a h a h a r o t
mahal	m a h a l
mahalaga	m a h a l a g a
mahalagang	m a h a l a g a ng
mahalumigmig	m a h a l u m i g m i
mahangin	m a h a ng i n
mahapdi	m a h a p t i q
mahapding	m a h a p d i ng
mahigit	m a h i g i t
mahigpit	m a h i g p i t
mahihina't	m a h i h i n a t
mahihirap	m a h i h i r a p
mahihirapan	m a h i h i r a p a n
mahilig	m a h i l i g
mahina	m a h i n a
mahinto	m a h i n t o
mahirap	m a h i r a p
mahirapan	m a h i r a p a n
mahiwagang	m a h i w a g a ng
mahuli	m a h u l i q
mahulog	m a h u l o g
mahusay	m a h u s ay
maibsan	m a q i b s a n
maigi	m a q i g i
maihanap	m a q i h a n a p
maiingay	m a q i q i ng ay
maiisip	m a i q i s i p
maiiwan	m a q i w a n
maikli	m a q i k l i q
maikling	m a q i k l i ng
mailipat	m a q i l i p a t
mailuluwas	m a q i l u l u w a s
mainam	m a q i n a m
maingat	m a q i ng a t
maingay	m a q i ng ay
mainggitin	m a q i ng g i t i n
mainit	m a q i n i t
maintenance	m a q i n t e n a n s
maipagtanggol	m a q i p a g t a ng g o l
maipapayo	m a q i p a p a y o q
maipatupad	m a q i p a t u p a d
maipit	m a q i p i t
mairehistro	m a q e r e h i s t r o
mairerekomenda	m a q e r e r e k o m e n d a
mairrehistro	m a q i r e h i s t r o
mais	m a q i s
maisakatuparan	m a q i s a k a t u p a r a n
maisama	m a q i s a m a
maisasagawa	m a q i s a s a g a w a
maisip	m a q i s i p
maisulong	m a q i s u l o ng
maitatakwil	m a q i t a t a k w i l
maituturing	m a q i t u t u r i ng
maiwan	m a q i w a n
maiwasan	m a q i w a s a n
maiwasto	m a q i w a s t o
maka-apekto	m a k a q a p e k t o
maka-usap	m a k a q u s a p
makaakyat	m a k a q a k y a t
makaapekto	m a k a q a p e k t o
makababasa	m a k a b a b a s a
makabagong	m a k a b a g o ng
makabangon	m a k a b a ng o n
makabasa	m a k a b a s a
makabawi	m a k a b a w i
makabayan	m a k a b a y a n
makabubuting	m a k a b u b u t i ng
makabuluhan	m a k a b u l u h a n
makadalaan	m a k a d a l a q a n
makadiyos	m a k a jh o s
makagawa	m a k a g a w a
makagulapay	m a k a g u l a p ay
makahinga	m a k a h i ng a
makaikot	m a k a q i k o t
makaita	m a k a q i t a
makakaapekto	m a k a k a q a p e k t o
makakabasa	m a k a k a b a s a
makakabawi	m a k a k a b a w i
makakagawa	m a k a k a g a w a
makakahanap	m a k a k a h a n a p
makakain	m a k a k a q i n
makakapal	m a k a k a p a l
makakarating	m a k a k a r a t i ng
makakatulad	m a k a k a t u l a d
makakaya	m a k a k a y a
makakilos	m a k a k i l o s
makakuha	m a k a k u h a q
makalawa	m a k a l a w a
makalikha	m a k a l i k a
makalipas	m a k a l i p a s
makalumang	m a k a l u m a ng
makapag-uudyok	m a k a p a g q u d y o k
makapagbibigay	m a k a p a g b i b i g ay
makapagbigay	m a k a p a g b i g ay
makapaghiganti	m a k a p a g h i g a n t i
makapagigay	m a k a p a g i g ay
makapaglaro	m a k a p a g l a r o
makapagpatanggal	m a k a p a g p a t a ng g a l
makapagplano	m a k a p a g p l a n o
makapagsasabi	m a k a p a g s a s a b i
makapagtala	m a k a p a g t a l a
makapagtrabaho	m a k a p a g t r a b a h o q
makapal	m a k a p a l
makapamitas	m a k a p a m i t a s
makapamuno	m a k a p a m u n o
makaraan	m a k a r a q a n
makararamdam	m a k a r a r a m d a m
makararating	m a k a r a r a t i ng
makarating	m a k a r a t i ng
makasali	m a k a s a l i q
makasama	m a k a s a m a
makasasagot	m a k a s a s a g o t
makasuporta	m a k a s u p o er t a
makatayo	m a k a t a y o q
makati	m a k a t i
makatitipid	m a k a t i t i p i d
makatulong	m a k a t u l u ng
makatutulong	m a k a t u t u l o ng
makihalubilo	m a k i h a l u b i l o
makikipag-pulong	m a k i k i p a g p u l o ng
makikipag-sex	m a k i k i p a g q s e k s
makikisuyo	m a k i k i s u y o q
makikita	m a k i k i t a
makilala	m a k i l a l a
makilalang	m a k i l a l a ng
makinig	m a k i n i g
makipag-usap	m a k i p a g q u s a p
makipagkasundo	m a k i p a g k a s u n d o
makipagtalik	m a k i p a g t a l i k
makipagtulungan	m a k i p a g t u l u ng a n
makisig	m a k i s i g
makita	m a k i t a
makitang	m a k i t a ng
makitid	m a k i t i d
makitungo	m a k i t u ng o
makuha	m a k u h a q
makukuha	m a k u k u h a q
makulimlim	m a k u l i m l i m
malaba-nan	m a l a b a q n a n
malabis	m a l a b i s
malabon	m a l a b o n
malacaang	m a l a k a q a ng
malacanang	m a l a k a ny a ng
malaganap	m a l a g a n a p
malakanyang	m a l a k a n y a ng
malakas	m a l a k a s
malaki	m a l a k i
malaking	m a l a k i ng
malalakas	m a l a l a k a s
malalaki	m a l a l a k i
malalaki't	m a l a l a k i t
malalaking	m a l a l a k i ng
malalamig	m a l a l a m i g
malalim	m a l a l i m
malaman	m a l a m a n
malamang	m a l a m a ng
malamig	m a l a m i g
malangsang	m a l a n s a ng
malansang	m a l a n s a ng
malaong	m a l a q o ng
malapit	m a l a p i t
malate	m a l a t e
malay	m a l ay
malaya	m a l a y a
malayan	m a l a y a n
malayang	m a l a y a ng
malayo	m a l a y o q
malayong	m a l a y o ng
malaysia	m a l a y s i y a
malcolm	m a l k o l m
mali	m a l i
maliban	m a l i b a n
maligayang	m a l i g a y a ng
maligo	m a l i g o q
maliit	m a l i q i t
malikot	m a l i k o t
maliligo	m a l i l i g o q
maliliit	m a l i l i q i t
malimit	m a l i m i t
malinaw	m a l i n aw
malinawan	m a l i n a w a n
maling	m a l i ng
malinis	m a l i n i s
maliwanag	m a l i w a n a g
malkling	m o k l i ng
mall	m o l
malls	m o l s
malo	m a l o
maluat	m a l u w a t
malungkot	m a l u ng k o t
malunod	m a l u n o d
malusog	m a l u s o g
maluto'y	m a l u t oy
mama	m a m a
mama-mama	m a m a q m a m a
mamahalin	m a m a h a l i n
mamaluktot	m a m a l u k t o t
mamamayan	m a m a m a y a n
mamamayang	m a m a m a y a ng
mamarkahan	m a m a r k a h a n
mamatay	m a m a t ay
mamaya	m a m a y a
mamayan	m a m a y a n
mamayang	m a m a y a ng
mambabasa	m a m b a b a s a
mamimili	m a m i m i l i
mamimitas	m a m i m i t a s
mamitas	m a m i t a s
mamuhunan	m a m u h u n a n
mamulot	m a m u l o t
mamunga	m a m u ng a
mamuno	m a m u n o
man	m a n
management	m a n e jh m e n t
manalangin	m a n a l a ng i n
mananakop	m a n a n a k o p
mananalaysay	m a n a n a l a y s ay
mananalo	m a n a n a l o
mananatili	m a n a n a t i l i q
mananatiling	m a n a n a t i l i ng
mandaluyong	m a n d a l u y o ng
mandirigma	m a n d i r i g m a
mang	m a ng
mang-loot	m a ng l o q o t
mangahas	m a ng a h a s
mangamba	m a ng a m b a
mangangailangan	m a ng a ng a q i l a ng a n
mangangalakal	m a ng a ng a l a k a l
mangga	m a ng g a
manggagaling	m a ng g a g a l i ng
manggagawa	m a ng g a g a w a
manggahan	m a ng g a h a n
manggang	m a ng g a ng
manghahawak	m a ng h a h a w a k
mangibang	m a ng i b a ng
mangingisda	m a ng i ng i s d a
mangingisda-mangingisda	m a ng i ng i s d a q m a ng i ng i s d a
mangoes	m a ng o s
mangopo	m a ng o p o
mangopya	m a ng o p y a
mangyari	m a ng a y a r i
mangyayari	m a ng y a y a r i
mangyayari'y	m a ng y a y a r i
manigarilyo	m a n i g a r i ly o q
manigong	m a n i g o ng
manila	m a n i l a
maninilaw	m a n i n i l aw
manipis	m a n i p i s
manipulation	m a n i p u l ey sh uh n
manirahan	m a n i r a h a n
maniwala	m a n i w a l a q
manlalaro	m a n l a l a r o
manlulupig	m a n l u l u p i g
manok	m a n o k
mansion	m a n s i q o n
manugang	m a n u g a ng
manulife	m a ny u l ay p
manunulat	m a n u n u l a t
mapababa	m a p a b a b a
mapadaan	m a p a d a q a n
mapag-aalinlanganang	m a p a g q a a l i n l a ng a n a ng
mapag-alaman	m a p a g q a l a m a n
mapag-alinlangan	m a p a g q a l i n l a ng a n
mapagalitan	m a p a g a l i t a n
mapagbigay	m a p a g b i g ay
mapaghiganti	m a p a g h i g a n t i
mapagiwanan	m a p a g i w a n a n
mapaglakbay	m a p a g l a k b ay
mapagod	m a p a g o d
mapagtiis	m a p a g t i q i s
mapait	m a p a q i t
mapakali	m a p a
mapako	m a p a k o q
mapalad	m a p a l a d
mapanatili	m a p a n a t i l i q
mapanlinlang	m a p a n l i n l a ng
mapansin	m a p a n s i n
mapapaapaw	m a p a p a q a p aw
mapapansin	m a p a p a n s i n
mapapansing	m a p a p a n s i ng
mapapasaiyo	m a p a p a s a q i y o q
maparine	m a p a r i n
mapaso	m a p a s o
mapatunayan	m a p a t u n a y a n
mapigilan	m a p i g i l a n
mapuno	m a p u n o
marahan	m a r a h a n
marahas	m a r a h a s
marahil	m a r a h i l
marahuyo	m a r a h u y o q
maramdaman	m a r a m d a m a n
marami	m a r a m i
maraming	m a r a m i ng
marapat	m a r a p a t
mararamdaman	m a r a r a m d a m a n
marawi	m a r a w i
marcela	m a er s i l a
marco	m a er k o
marcos	m a er k o s
maresolba	m a r e s o l b a
margarita	m a er g a r i t a
margarito	m a er g a r i t o
maria	m a er i y a
maribago	m a r i b a g o q
maricel	m a r i s e l
marikina	m a r i k i n a
marilou	m a r i l u
marinig	m a r i n i g
marissa	m a r i s a
marites	m a r i t e s
mariveles	m a r e v e l e s
marivic	m a er i v i k
mark	m a er k
marker	m a r k er
markings	m a r k i ng s
marlon	m a er l u n
marso	m a r s o
martes	m a r t e s
martin	m a er t i n
martir	m a er t i r
marunong	m a r u n o ng
marvin	m a er v i n
mary	m e r i
mas	m a s
masakim	m a s a k i m
masakit	m a s a k i t
masalinan	m a s a l i n a n
masalita	m a s a l i t a
masama	m a s a m a
masamang	m a s a m a ng
masapi	m a s a p i
masasabi	m a s a s a b i
masasabing	m a s a s a b i ng
masasabunot	m a s a s a b u n o t
masasaksihan	m a s a s a k s i h a n
masasamang	m a s a s a m a ng
masasapantahang	m a s a s a p a n t a h a ng
masaway	m a s a w a y
masaya	m a s a y a
masayang	m a s a y a ng
masbate	m a s b ey t
masinsing	m a s i n s i ng
masipag	m a s i p a g
masira	m a s i r a
masisilayan	m a s i s i l a y a n
masisiyahan	m a s i s i y a h a n
maski	m a s k i
masugpo	m a s u g p o
masukal	m a s u k a l
masulat	m a s u l a t
masupil	m a s u p i l
masusing	m a s u s i ng
masusulyapan	m a s u s u l y a p a n
masyadong	m a sh a d o ng
mata	m a t a
mataaas	m a t a a a s
mataas	m a t a q a s
matagal	m a t a g a l
matagpuan	m a t a g p u q a n
matagumpay	m a t a g u m p ay
matahimik	m a t a h i m i k
matakot	m a t a k o t
matalas	m a t a l a s
matalino	m a t a l i n o
matalinong	m a t a l i n o ng
matam-is	m a t a m q i s
matamis	m a t a m i s
matamlay	m a t a m l ay
matanda	m a t a n d a
matandang	m a t a n d a ng
matang	m a t a ng
matanggal	m a t a ng g a l
matanggap	m a t a ng g a p
matapang	m a t a p a ng
matapat	m a t a p a t
matapos	m a t a p o s
matatag	m a t a t a g
matatagpuan	m a t a t a g p u q a n
matatanda	m a t a t a n d a
matatapatan	m a t a t a p a t a n
matatapos	m a t a t a p o s
mateo	m a t e y o
materials	m a t e r i y a l s
materyales	m a t e r y a l e s
matet	m a t e t
mati	m a t i
matibay	m a t i b ay
matiis	m a t i q i s
matimbang	m a t i m b a ng
matinding	m a t i n d i ng
matingkad	m a t i ng k a d
matinik	m a t i n i k
matiyagang	m a t y a g a ng
matsing	m a ch i ng
matthew	m a t th iw
matuklasan	m a t u k l a s a n
matulin	m a t u l i n
matuling	m a t u l i ng
matulog	m a t u l o g
matulungan	m a t u l u ng a n
matulungin	m a t u l u ng i n
matumal	m a t u m a l
matutong	m a t u t o ng
matutukoy	m a t u t u k oy
matutulis	m a t u t u l i s
matutulungan	m a t u t u l u ng a n
matutunghayan	m a t u t u ng h a y a n
matutupad	m a t u t u p a d
matutuyo	m a t u t u y o q
maubos	m a q o b u s
maulap	m a q u l a p
mauna	m a q u n a
maunawaan	m a q u n a w a q a n
maunlad	m a q u n l a d
maupo	m a q u p o
mauuna	m a q u u n a
maverick	m a v er i k
mawakwak	m a w a k w a k
mawala	m a w a l a q
mawalang	m a w a l a ng
mawawala	m a w a w a l a q
mawawalan	m a w a w a l a n
may	m a y
may-ari	m a y q a r i
may-kalabuan	m a y q k a l a b u q a n
maya	m a y a
maya't	m a y a t
maya-	m a y a
maya-maya	m a y a m a y a q
mayaman	m a y a m a n
maynila	m a n i l a
maynilad	m a n i l a d
mayo	m a y o
mayon	m a y o n
mayroon	m a y r o q o n
mayroong	m a y r o q o ng
mayruong	m a y r o o ng
mcci	m s i s i q ay
me	m i
mechado	m i ch a d o
media	m e d i y a
medical	m e d i k a l
medicine	m e d i k ay n
medya	m e jh a
meeting	m i t i ng
megamall	m e g a m o l
megaworld	m i g a w uh er l d
melanie	m e l a n i
member	m e m b er
mendoza	m e n d o z a
mensahe	m e n s a h e
meralco	m e r a l k o
mercado	m er k a d o
merkado	m e r k a d o
meron	m e r o n
mesa	m e s a
messages	m e s a jh e s
metabolism	m e t a b o l i s m
metro	m e t r o
metrobank	m e t r o b a ng k
metropolitan	m e t er o p o l i t a n
meycauayan	m ey k a w a y a n
mga	m a ng a
mia	m i q a
michael	m ay k e l
michelle	m i sh e l
midtown	m i d t aw n
miguel	m i g e l
mikrobyo	m i k r o b y o q
miles	m i l e s
militarisasyon	m i l i t a r i s a sh o n
millennium	m i l e ny u m
milligram	m i l i g er ae m
million	m i l y u n
milya	m i ly a
milyong	m i ly o ng
milyun-milyong	m i ly u n q m i ly o ng
minamahal	m i n a m a h a l
minana	m i n a n a
minatamis	m i n a t a m i s
mindanao	m i n d a n aw
mindanaw	m i n d a n aw
mines	m ay n s
mining	m ay n i ng
minsan	m i n s a n
minsanan	m i n s a n a n
minsang	m i n s a ng
mintis	m i n t i s
minuminuto	m i n u m i n u t o
minuto	m i n u t o
mismo	m i s m o
mismong	m i s m o ng
mitch	m i ch
mithiin	m i t h i q i n
miting	m i t i ng
miyerkules	m y e r k u l e s
mo	m o
mo'y	m oy
mobile	m o b e l
model	m o d e l
modernong	m u d e r n o ng
molina	m o l i n a
molo	m o l o
momentum	m o m e n t u m
mong	m o ng
monica	m u n i k a
montalbo	m o n t a l b o
monte	m o n t e
month	m o n t
monumento	m o ny u m e n t o
mood	m o q o d
moody's	m u jh s
moog	m o q o g
moral	m o r a l
morcon	m o er k o n
most	m o s t
motel	m o t e l
mother	m o d er
mouth	m aw dh
mr	m er
mrt	m er t
muhi	m u h i q
muhi-muhi	m u h i m u h i q
muhing-muhi	m u h i ng m u h i q
mukha	m u k h a q
mukhang	m u k h a ng
mula	m u l a
muli	m u l i q
muling	m u l i ng
muna	m u n a
muna'y	m u n ay
munang	m u n a ng
mundo	m u n d o
muntik	m u n t i k
munting	m u n t i ng
muntinlupa	m u n t i n l u p a
mura	m u r a
murang	m u r a ng
museum	m u s i u m
mushroom	m u sh r u m
muslims	m u s l i m s
muta	m u t a
my	m i
n'yan	n y a n
na	n a
na't	n a t
na-experience	n a q e k s p e r i y e n s
na-export	n a q e k s p o er t
na-re-resolba	n a q r e r e s o l b a
naaakyat	n a q a q a k y a t
naaalarma	n a q a q a l a r m a
naagapan	n a q a g a p a n
naamoy	n a q a m oy
naaning	n a q a n i ng
naapektuhan	n a q a p e k t u h a n
naari	n a q a r i
nababagay	n a b a b a g ay
nababahala	n a b a b a h a l a
nababatay	n a b a b a t ay
nababatid	n a b a b a t i d
nabahala	n a b a h a l a
nabalian	n a b a l i q a n
nabanggit	n a b a ng g i t
nabasag	n a b a s a g
nabatid	n a b a t i d
nabibiliran	n a b i b i l i r a n
nabibingit	n a b i b i ng i t
nabigla't	n a b i g l a t
nabigyan	n a b i g y a n
nabili	n a b i l i q
nabubuhay	n a b u b u h ay
nabulagan	n a b u l a g a n
nabuo	n a b u q o
nadama	n a d a m a
nadapa	n a d a p a
nadarang	n a d a r a ng
nadatnan	n a d a t n a n
nadayang	n a d a y a ng
nade-dehydrate	n a d e d i h y d r ey t
nadulas	n a d u l a s
nag-	n a g
nag-aabang	n a g q a q a b a ng
nag-aantok	n a g q a q a n t o k
nag-aaral	n a g q a q a r a l
nag-akma	n a g a k m a
nag-aksaya	n a g a k s a y a
nag-click	n a g c l i k
nag-i-import	n a g q i q i m p o er t
nag-ibayo	n a g q i b a y o q
nag-iibayo	n a g q i q i b a y o q
nag-iisa	n a g q i q i s a
nag-isip	n a g q i s i p
nag-rollback	n a g q r o l b a k
nag-twist	n a g t w i s t
nag-usbong	n a g q u s b o ng
nag-uumpisa	n a g q u q u m p i s a
nag-uumpugang	n a g q u q u m p u g a ng
nag-uuntugang	n a g q u q u n t u g a ng
naga	n a g a
nagagalit	n a g a g a l i t
nagagawa	n a g a g a w a
nagalit	n a g a l i t
nagawa	n a g a w a
nagbaba	n a g b a q b a q
nagbabadya	n a g b a q b a d y a
nagbabagsakang	n a g b a b a g s a k a ng
nagbabahang	n a g b a b a h a ng
nagbabala	n a g b a b a l a
nagbabanlaw	n a g b a b a n l aw
nagbabantang	n a g b a b a n t a ng
nagbabayad	n a g b a b a y a d
nagbalang	n a g b a l a ng
nagbalik	n a g b a l i k
nagbanta	n a g b a n t a
nagbayo	n a g b a y o q
nagbibigay	n a g b i b i g ay
nagbibigay-daang	n a g b i b i g ay d a a ng
nagbibigay-galang	n a g b i b i g ay q g a l a ng
nagbigay	n a g b i g ay
nagbukas	n a g b u k a s
nagdaan	n a g d a q a n
nagdaang	n a g d a q a ng
nagdadala	n a g d a d a l a
nagdala	n a g d a l a
nagdaos	n a g d a o s
nagdaramdam	n a g d a r a m d a m
nagdarasal	n a g d a r a s a l
nagdedeklara	n a g d e d e k l a r a
nagdugo	n a g d u g u q
naggagawad	n a g g a g a w a d
naghahanap	n a g h a h a n a p
naghahanda	n a g h a h a n d a
naghahangad	n a g h a h a ng a d
naghaharing	n a g h a h a r i ng
naghangad	n a g h a ng a d
naghihintay	n a g h i h i n t ay
naghihirap	n a g h i h i r a p
naghirap	n a g h i r a p
nagiging	n a g i g i ng
nagigipit	n a g i g i p i t
nagiibayo	n a g i q i b a y o
naging	n a g i ng
nagkaanak	n a g k a q a n a k
nagkakaisa	n a g k a g k a q i s a
nagkakaloob	n a g k a k a l o q o b
nagkakaroon	n a g k a k a r o q o n
nagkakasala	n a g k a k a s a l a
nagkakati	n a g k a k a t i
nagkaloob	n a g k a l o q o b
nagkamali	n a g k a m a l i
nagkaroon	n a g k a r o q o n
nagkatagpo	n a g k a t a g p o
nagkataon	n a g k a t a q o n
nagkatigdas	n a g k a t i g d a s
naglagak	n a g l a g a k
naglahad	n a g l a h a d
naglaho	n a g l a h o
naglahong	n a g l a h o ng
naglalahad	n a g l a l a h a d
naglalakad	n a g l a l a k a d
naglalakbay	n a g l a l a k b ay
naglalakihang	n a g l a l a k i h a ng
naglaon	n a g l a q o n
naglapat	n a g l a p a t
naglaro	n a g l a r o
naglinis	n a g l i n i s
naglunsad	n a g l u n s a d
nagluto	n a g l u t o q
nagmakaawa	n a g m a k a q a w a
nagmamatigas	n a g m a m a t i g a s
nagmano	n a g m a n o
nagmula	n a g m u l a
nagmumula	n a g m u m u l a
nagnanais	n a g n a n a q i s
nagpahayag	n a g p a h a y a g
nagpakitang	n a g p a k i t a ng
nagpala	n a g p a l a
nagpamalas	n a g p a m a l a s
nagpapabasa	n a g p a p a b a s a
nagpapahirap	n a g p a p a h i r a p
nagpapakilala	n a g p a p a k i l a l a
nagpapakilalang	n a g p a p a k i l a l a ng
nagpapakitang	n a g p a p a k i t a ng
nagpapatamlay	n a g p a p a t a m l ay
nagpapatunay	n a g p a p a t u n ay
nagpapatupad	n a g p a p a t u p a d
nagpasabi	n a g p a s a b i
nagpatuloy	n a g p a t u l oy
nagpatupad	n a g p a t u p a d
nagpipilit	n a g p i p i l i t
nagprotesta	n a g p r o t e s t a
nagpu-produce	n a g p u p r u d u s
nagpunta	n a g p u n t a
nagresulta	n a g r e s u l t a
nagretiro	n a g r e t i r o
nagsabi	n a g s a b i
nagsaing	n a g s a i ng
nagsampa	n a g s a m p a
nagsanib	n a g s a n i b
nagsara	n a g s a r a
nagsasabing	n a g s a s a b i ng
nagsasabon	n a g s a s a b u n
nagsidalo	n a g s i d a l o
nagsilabas	n a g s i l a b a s
nagsimula	n a g s i m u l a
nagsimulang	n a g s i m u l a ng
nagsisagupa	n a g s i s a g u p a
nagsisipagsalita	n a g s i s i p a g s a l i t a
nagsisipamahala	n a g s i s i p a m a h a l a
nagsusugat	n a g s u s u g a t
nagsusuka	n a g s u s u k a
nagsusulat	n a g s u s u l a t
nagsusuot	n a g s u s u q u t
nagsusuplay	n a g s u s u p l ay
nagtagal	n a g t a g a l
nagtago	n a g t a g o
nagtagpo	n a g t a g p o
nagtakbuhan	n a g t a k b u h a n
nagtala	n a g t a l a
nagtanim	n a g t a n i m
nagtanong	n a g t a n o ng
nagtataglay	n a g t a t a g l ay
nagtatago	n a g t a t a g o q
nagtatawa	n a g t a t a w a
nagtayo	n a g t a y o q
nagtila-impiyerno	n a g t i l a q i m p y e r n o
nagtipon	n a g t i p o n
nagtungo	n a g t u ng o
nagturo	n a g t u r o
nagugutom	n a g u g u t u m
nagulat	n a g u l a t
nagustuhan	n a g u s t u h a n
nagwawagi	n a g w a w a g i
nagwawakas	n a g w a w a k a s
nagwika	n a g w i k a w
nahaharap	n a h a h a r a p
nahalal	n a h a l a l
nahampas	n a h a m p a s
nahanap	n a h a n a p
nahiga	n a h i g a
nahihilo	n a h i h i l o
nahihirapan	n a h i h i r a p a n
nahihirapang	n a h i h i r a p a ng
nahihiya	n a h i h i y a
nahikayat	n a h i k a y a t
nahitik	n a h i t i k
nahuhumaling	n a h u h u m a l i ng
nahuli-nahuli	n a h u l i n a h u l i q
nahuling	n a h u l i ng
nahulog	n a h u l o g
nai-stroke	n a q i s t er ow k
naia	n a q i y a
naibigay	n a q i b i g ay
naibsan	n a q i b s a n
naihahabol	n a q i h a h a b u l
naiinom	n a i q i n o m
naiintindihan	n a i q i n t i n d i h a n
naiipit	n a q i q i p i t
naiisahan	n a i q i s a h a n
naikaw	n a q i k aw
nailalabas	n a q i l a l a b a s
naintindihan	n a q i n t i n d i h a n
naipalabas	n a q i p a l a b a s
naipaparating	n a q i p a p a r a t i ng
naipit	n a q i p i t
naipon	n a q i p o n
nais	n a q i s
naisipan	n a q i s i p a n
naitago	n a q i t a g o q
naitalang	n a q i t a l a ng
naitulong	n a q i t u l o ng
naitutulong	n a q i t u t u l o ng
naiwan	n a q i w a n
naiwang	n a i w a ng
naka-recover	n a k a q r e k a v er
naka-reseta	n a k a q r e s e t a
nakaahon	n a k a q a h o n
nakaalis	n a k a q a l i s
nakababatang	n a k a b a b a t a ng
nakabalik	n a k a b a l i k
nakabangga	n a k a b a ng g a
nakabasa	n a k a b a s a
nakabase	n a k a b a s e
nakabitin	n a k a b i t i n
nakabuo	n a k a b u q o
nakagat	n a k a g a t
nakahanda	n a k a h a n d a
nakahandang	n a k a h a n d a ng
nakaharap	n a k a h a r a p
nakahuli	n a k a h u l i q
nakain	n a k a q i n
nakaiwas	n a k a q i w a s
nakakaapekto	n a k a k a q a p e k t o
nakakabili	n a k a k a b i l i q
nakakadagdag	n a k a k a d a g d a g
nakakahawa	n a k a k a h a w a
nakakahinayang	n a k a k a h i n a y a ng
nakakakain	n a k a k a k a q i n
nakakalimot	n a k a k a l i m o t
nakakapagod	n a k a k a p a g o d
nakakapawi	n a k a k a p a w i
nakakapinsala	n a k a k a p i n s a l a q
nakakasama	n a k a k a s a m a
nakakatawang	n a k a k a t a w a ng
nakakita	n a k a k i t a
nakalalait	n a k a l a l a q i t
nakalap	n a k a l a p
nakalilipas	n a k a l i l i p a s
nakalipad	n a k a l i p a d
nakalipas	n a k a l i p a s
nakamit	n a k a m i t
nakanino	n a k a n i n o
nakapagtala	n a k a p a g t a l a
nakapagtrabaho	n a k a p a g t r a b a h o q
nakapaloob	n a k a p a l o q o b
nakapasok	n a k a p a s o k
nakapokus	n a k a p o k u s
nakaraan	n a k a r a q a n
nakaraang	n a k a r a q a ng
nakaramdam	n a k a r a m d a m
nakasalamuha	n a k a s a l a m u h a q
nakasama	n a k a s a m a
nakasunod	n a k a s u n o d
nakataas	n a k a t a q a s
nakatago	n a k a t a g o q
nakatakas	n a k a t a k a s
nakatakda	n a k a t a k d a
nakatakdang	n a k a t a k d a ng
nakatapos	n a k a t a p o s
nakatatanda	n a k a t a t a n d a
nakatindig	n a k a t i n d i g
nakatipid	n a k a t i p i d
nakatira	n a k a t i r a
nakatitipid	n a k a t i t i p i d
nakatitiyak	n a k a t i t i y a k
nakatulong	n a k a t u l u ng
nakatunganga	n a k a t u ng a ng a
nakatuon	n a k a t u q o n
nakauniporme	n a k a q u n i p o r m e
nakawala'y	n a k a w a l ay
nakayanan	n a k a y a n a n
nakikilala	n a k i k i l a l a
nakikinig	n a k i k i n i g
nakikipag-ugnayan	n a k i k i p a g q u g n a y a n
nakikiramay	n a k i k i r a m ay
nakikita	n a k i k i t a
nakikitang	n a k i k i t a ng
nakipagbaka	n a k i p a g b a k a
nakipagkaibigan	n a k i p a g k a q i b i g a n
nakipagkasundo	n a k i p a g k a s u n d o
nakipagsapalaran	n a k i p a g s a p a l a r a n
nakita	n a k i t a
nakitil	n a k i t i l
nakokolekta	n a k o k o l e k t a
nakolekta	n a k o l e k t a
naku	n a k u
nakuha	n a k u h a q
nakuhang	n a k u h a ng
nakukuha	n a k u k u h a q
nalalaman	n a l a l a m a n
nalaman	n a l a m a n
nalamuyot	n a l a m u y o t
nalawayan	n a l a w a y a n
naligo	n a l i g o q
nalilimutan	n a l i l i m u t a n
nalugi	n a l u g i
nalulunod	n a l u l u n o d
nama	n a m a
nama'y	n a m ay
namamatay	n a m a m a t ay
namamayagpag	n a m a m a y a g p a g
naman	n a m a n
namang	n a m a ng
namatay	n a m a t ay
namatayan	n a m a t a y a n
name	n a m e
namili	n a m i l i
namimintog	n a m i m i n t o g
namimintong	n a m i m i n t o ng
namin	n a m i n
naming	n a m i ng
namitas	n a m i t a s
namumuhanan	n a m u m u h a n a n
namumuhunan	n a m u m u h u n a n
namumuong	n a m u m u q u ng
namuno	n a m u n o
nana	n a n a
nanamlay	n a n a m l ay
nananatiling	n a n a n a t i l i ng
nanatiling	n a n a t i l i ng
nanay	n a n ay
nang	n a ng
nangagalit	n a ng a g a l i t
nangagbitin	n a ng a g b i t i n
nangagsiurong	n a ng a g s i q u r o ng
nangagtaas	n a ng a g t a a s
nanganak	n a ng a n a k
nangangailangan	n a ng a ng ay l a ng a n
nangangamba	n a ng a ng a m b a
nanganganib	n a ng a ng a n i b
nangapoot	n a ng a p u q o t
nangatakot	n a ng a t a k o t
nanggaling	n a ng g a l i ng
nanggigigil	n a ng g i g i g i l
nangiti	n a ng i t i
nangitim	n a ng i t i m
nanguha	n a ng u h a
nangunguna	n a ng u ng u n a
nangyari	n a ng a y a r i
nangyaring	n a ng a y a r i ng
nangyayari	n a ng y a y a r i
naninigarilyo	n a n i n i g a r i ly o q
naninikip	n a n i n i k i p
naninira	n a n i n i r a
naninirahan	n a n i n i r a h a n
naniniwala	n a n i n i w a l a q
nanirahan	n a n i r a h a n
naniwala	n a n i w a l a q
nanlalabo	n a n l a l a b o
napag-alaman	n a p a g q a l a m a n
napag-alamang	n a p a g q a l a m a ng
napag-aralan	n a p a g q a r a l a n
napagkasunduan	n a p a g k a s u n d u q a n
napaglalalangan	n a p a g l a l a l a ng a n
napagtanto	n a p a g t a n t o
napahayag	n a p a h a y a g
napaka-pangkaraniwang	n a p a k a p a ng k a er a n i w a ng
napakabigat	n a p a k a b i g a t
napakabitan	n a p a k a b i t a n
napakabuti	n a p a k a b u t i
napakagandang	n a p a k a g a n d a ng
napakalawak	n a p a k a l a w a k
napakalikot	n a p a k a l i k o t
napakaraming	n a p a k a r a m i ng
napanood	n a p a n u d
napansin	n a p a n s i n
napasa-mahinang	n a p a s a m a h i n a ng
napasong	n a p a s o ng
napatunayan	n a p a t u n a y a n
napilay	n a p i l ay
napili	n a p i l i
napilitan	n a p i l i t a n
napipintong	n a p i p i n t o ng
napipisa	n a p i p i s a
napipisil	n a p i p i s i l
napocor	n a p o k o r
napopoot	n a p o p u q o t
napu't	n a p u t
napulot	n a p u l o t
naragdagan	n a r a g d a g a n
naramdaman	n a r a m d a m a n
nararamdaman	n a r a r a m d a m a n
nararanasan	n a r a r a ny a s a n
nararapat	n a r a r a p a t
narinig	n a r i n i g
narito	n a r i t o
nariyan	n a r i y a n
naroon	n a r o q o n
naruon	n a r o q o n
nasa	n a s a
nasa-kuwentong	n a s a q k w e n t o ng
nasaan	n a s a q a n
nasabing	n a s a b i ng
nasaktang	n a s a k t a ng
nasanay	n a s a n ay
nasasakop	n a s a s a k o p
nasasaktan	n a s a s a k t a n
nasasangkap	n a s a s a ng k a p
nasimulan	n a s i m u l a n
nasira	n a s i r a
nasisiraan	n a s i s i r a q a n
nasisiyahang	n a s i s i y a h a ng
nasugatan	n a s u g a t a n
nasusugatan	n a s u s u g a t a n
nasuya	n a s u y a q
nasyonalismo'y	n a sh u n a l i s m oy
nata	n a t a
natagalan	n a t a g a l a n
natakot	n a t a k o t
natanaw	n a t a n aw
natapos	n a t a p o s
natatabunan	n a t a t a b u n a n
natatagpuan	n a t a t a g p u q a n
natatakot	n a t a t a k o t
natatapat	n a t a t a p a t
natawa	n a t a w a
natawag	n a t a w a g
natin	n a t i n
nating	n a t i ng
national	n a sh u n a l
nations	n a sh uh n s
natirang	n a t i r a ng
natiy	n a t i
natukoy	n a t u k oy
natural	n a t u r a l
naturang	n a t u r a ng
natutulog	n a t u t u l o g
natutunan	n a t u t u n a n
naudlot	n a q u d l o t
naulingan	n a q u l i ng a n
naunang	n a q u n a ng
naunawaan	n a q u n a w a q a n
nauukol	n a q u u k o l
navarro	n a v a r o
navotas	n a v o t a s
nawa	n a w a
nawala	n a w a l a q
nawalan	n a w a l a n
nawalay	n a w a l ay
nawawala	n a w a w a l a q
nayo't	n a y o t
nayon	n a y o n
nea	ny a
neda	n i d a
negosyante	n e g o sh a n t i
negosyo	n e g o sh o q
negosyo'	n e g o sh o q
neri	n e r i
network	n e t w er k
new	ny u
news	ny u s
ng	ng
nga	ng a
ngang	ng a ng
ngani	ng a n i
ngay-on	ng a y q o n
ngayon	ng a y o n
ngayong	ng a y o ng
ngipin	ng i p i n
nguni't	ng u n i t
ngunit	ng u n i t
ni	n i
nicarosa	n i k a r u s a
nick	n i k
nicole	n i k ow l
nido	n i d o
nigarilyo	n i g a r i ly o q
nigeria	n i jh e r i y a
nightclubs	n ay t k l uh b s
niko	n i k o
nila	n i l a
nilabag	n i l a b a g
nilabanan	n i l a b a n a n
nilaga	n i l a g a
nilakaran	n i l a k a r a n
nilalagnat	n i l a l a g n a t
nilalapatan	n i l a l a p a t a n
nilalayong	n i l a l a y o ng
nilang	n i l a ng
nilapitan	n i l a p i t a n
nilasing	n i l a s i ng
nilo	n i l o
nilusob	n i l u s o b
nilusong	n i l u s o ng
niluto	n i l u t o
nina	n i n a
ninang	n i n a ng
nine	n ay n
nineteen	n i n e t i n
ninety	n i n e t i
ninety-five	n i n e t y q f ay v
ninety-nine	n i n e t i n ay n
ninety-one	n i n e t y q o n
ningas	n i ng a s
nino	n i n o
ninong	n i n o ng
ninos	n i n o s
ninoy	n i n oy
ninuno	n i n u n o
ninyo	n i ny o
ninyong	n i ny u ng
nitiglao	n i t i g l aw
nito	n i t o
nitong	n i t o ng
niy	n i y
niya	n i y a
niya'y	n i y a y
niyang	n i y a ng
niyaong	ny a q o ng
niyebe	ny e b e
niyo	n i y o q
niyog	n i y o g
niyong	n i y o ng
noah	n ow a
nobyembre	n o b y e m b r e
noel	n o w e l
noo	n o q o
noo'y	n o oy
noon	n o q o n
noong	n o q o ng
normal	n o er m a l
norte	n o er t e
norvasc	n o er v a s k
not	n o t
notbuk	n o t b u k
notebook	n o t e b o o k
novaliches	n o v a l i ch e s
nso	n s o
ntc	n t i s i
nuclear	n u k l i er
nueba	n w e b a
nueva	n w e v a
number	n a m b e er
numero	n u m i r o
nung	n o ng
nuon	n o q o n
nuong	n o q o ng
nyan	n y a n
nyo	ny o
o	q o
obligasyon	o b l i g a sh u n
obra	o b r a
obserbasyon	ao b s e r b a sh o n
ocampo	q o k a m p o
occult	q o k s u l t
ocean	q o sh y a n
of	q o v
officer	q o f i s er
ofw	o b w
ofws	o b w s
oh	q o
oil	q oy l
oily	oy l i
ok	o k
okasyon	q o k a sh u n
okay	q o k ay
okey	q o k ey
oktubre	q o k t u b r e
oliver	q o l i v er
olongapo	q o l o ng g a p u
olympia	q o ly m p i y a
omar	q o m a r
on-line	q o n l i n
one	w a n
one-day	q o n i d ay
ong	q o ng
ooperahan	q o a p e r a h a n
operahan	q o p e r a h a n
operasyon	q o p e r a sh u n
opisina	q o p i s i n a
opisyal	q o p i sh y a l
opo	q o p o
opsf	q o p s f
orange	q o r ey n jh
oras	q o r a s
oras-oras	q o r a s q o r a s
orasyon	q o r a sh o n
orchard	q o er ch a er d
organ	o er g a n
original	q o r ay i n a l
orihinal	q o r i h i n a l
oro	q o r o
ospital	q o s p i t a l
otop	q o t o p
otorisadong	q o t o r i s a d o ng
ove	a v
over-activity	q ow v er q a k t i v i t i
overseas	q ow v er s i s
oxford	q ao k s f er d
ozamiz	o z a m i z
pa	p a
paa	p a q a
paala-ala	p a q a l a q a l a
paalaala	p a q a l a a l a
paalam	p a q a l a m
paalisin	p a a l i s i n
paanan	p a q a n a n
paangat	p a q a ng a t
paano	p a q a n o
paanong	p a q a n o ng
paaralan	p a q a r a l a n
pabalik	p a b a l i k
pabitin	p a b i t i n
pablo	p a b l o
paborito	p a b o r i t o
paboritong	p a b o r i t o ng
pabula	p a b u l a
pabulang	p a b u l a ng
pacific	p a s i p i k
package	p a k e jh
padala	p a d a l a
pader	p a d er
paella	p a q e ly a
pag	p a g
pag-aakalang	p a g q a q a k a l a ng
pag-aalaga	p a g q a q a l a g a
pag-aalma	p a g q a q a l m a
pag-aangkat	p a g q a q a ng k a t
pag-aaral	p a g q a q a r a l
pag-aasawa	p a g q a q a s a w a
pag-angkat	p a g q a ng k a t
pag-arangkada	p a g q a r a ng k a d a
pag-arrive	p a g q a er ay v
pag-asa	p a g q a s a
pag-develop	p a g q d e v e l o p
pag-eexport	p a g q i e k s p o er t
pag-ganda	p a g q g a n d a
pag-ihi	p a g q i h i
pag-ihip	p a g q i h i p
pag-iimbak	p a g q i q i m b a k
pag-iinspeksyon	p a g q i q i n s p e k sh o n
pag-iisa	p a g q i q i s a
pag-ilag	p a g q i l a g
pag-inom	p a g q i n u m
pag-intindi	p a g q i n t i n d i
pag-lift	p a g l i f t
pag-oorganisa	p a g q o o er g e n q o er g a n
pag-papatupad	p a g p a p a t u p a d
pag-ubo	p a g q u b o q
pag-umpugin	p a g q u m p u g i n
pag-unlad	p a g q u n l a d
pag-usad	p a g q u s a d
pag-usapan	p a g q u s a p a n
pag-usbong	p a g q u s b o ng
pag-uugali	p a g q u q u g a l i q
pagadian	p a g a d i q a n
pagagandahin	p a g a g a n d a h i n
pagandahin	p a g a n d a h i n
pagawaan	p a g a w a q a n
pagbaba	p a g b a b a
pagbabago	p a g b a b a g o q
pagbabagong	p a g b a b a g o ng
pagbabalikan	p a g b a b a l i k a n
pagbabasa	p a g b a b a s a
pagbabayad	p a g b a b a y a d
pagbabayanihan	p a g b a b a y a n i h a n
pagbaha	p a g b a h a q
pagbalik	p a g b a l i k
pagbasa	p a g b a s a
pagbati	p a g b a t i q
pagbawas	p a g b a w a s
pagbawi	p a g b a w i
pagbayad	p a g b a y a d
pagbebenta	p a g b e b e n t a
pagbibigay	p a g b i b i g ay
pagbibilhan	p a g b i b i l h a n
pagbigkas	p a g b i g k a s
pagbilang	p a g b i l a ng
pagbili	p a g b i l i q
pagbubukas	p a g b u b u k a s
pagbubuwis	p a g b u b u w i s
pagbuhay	p a g b u h ay
pagdaan	p a g d a q a n
pagdadamayan	p a g d a d a m a y a n
pagdami	p a g d a m i
pagdaraanan	p a g d a r a q a n a n
pagdaramdam	p a g d a r a m d a m
pagdarasal	p a g d a r a s a l
pagdating	p a g d a t i ng
pagdonate	p a g d o n ey t
pagdurugo	p a g d u r u g u q
pagganda	p a g g a n d a
paggapang	p a g g a p a ng
paggawa	p a g g a w a
paggugugol	p a g g u g u g o l
pagguho	p a g g u h o
paghahalintulad	p a g h a h a l i n t u l a d
paghahanap	p a g h a h a n a p
paghahanda	p a g h a h a n d a
paghahangad	p a g h a h a ng a d
paghandaan	p a g h a n d a q a n
paghataw	p a g h a t aw
paghibo	p a g h i b o
paghihiganti	p a g h i h i g a n t i
paghihinagpis	p a g h i h i n a g p i s
paghihinala	p a g h i h i n a l a
paghihirap	p a g h i h i r a p
paghina	p a g h i n a
paghirit	p a g h i r i t
paghuhukay	p a g h u h u k ay
pagiging	p a g i g i ng
pagitan	p a g i t a n
pagka-ihi	p a g k a q i h i
pagkaalis	p a g k a q a l i s
pagkabaog	p a g k a b a q o g
pagkabata	p a g k a b a t a q
pagkabigla	p a g k a b i g l a
pagkadakila	p a g k a d a k i l a
pagkadating	p a g k a d a t i ng
pagkagastusan	p a g k a g a s t u s a n
pagkahaba-haba	p a g k a h a b a h a b a
pagkahiyang	p a g k a h i y a ng
pagkain	p a g k a q i n
pagkakabisa	p a g k a k a b i s a
pagkakabuklod	p a g k a k a b u k l o d
pagkakahampas	p a g k a k a h a m p a s
pagkakahawig	p a g k a k a h a w i g
pagkakaiba	p a g k a g k a q i b a
pagkakaisa'y	p a g k a g k a q i s ay
pagkakalugmok	p a g k a k a q l u g m o k
pagkakamali	p a g k a k a m a l i
pagkakaroon	p a g k a k a r o q o n
pagkakasala	p a g k a k a s a l a
pagkakataon	p a g k a k a t a q o n
pagkakataong	p a g k a k a t a q o ng
pagkakatulad	p a g k a k a t u l a d
pagkakautang	p a g k a k a q u t a ng
pagkakawakas	p a g k a k a w a k a s
pagkakayari	p a g k a k a y a r i
pagkalagas	p a g k a l a g a s
pagkalugi	p a g k a l u g i
pagkamaaaring	p a g k a m a q a q a r i ng
pagkamalikhain	p a g k a m a l i k h a q i n
pagkamatanda	p a g k a m a t a n d a
pagkaraan	p a g k a r a q a n
pagkarating	p a g k a r a t i ng
pagkat	p a g k a t
pagkatanda	p a g k a t a n d a
pagkatao	p a g k a t a o q
pagkatapos	p a g k a t a p o s
pagkawala	p a g k a w a l a q
pagkikita	p a g k i k i t a
pagkilala	p a g k i l a l a
pagkilos	p a g k i l o s
pagkuwentuhan	p a g k w e n t u h a n
paglabag	p a g l a b a g
paglaban	p a g l a b a n
paglago	p a g l a g o q
paglakas	p a g l a k a s
paglaki	p a g l a k i
paglalako	p a g l a l a k o
paglalaro	p a g l a l a r o
paglaruan	p a g l a r u q a n
paglawak	p a g l a w a k
paglaya	p a g l a y a
paglikha	p a g l i k h a
paglindol	p a g l i n d o l
paglipat	p a g l i p a t
paglukso	p a g l u k s u
pagluto	p a g l u t o q
pagmakitid	p a g m a k i t i d
pagmamadaling	p a g m a m a d a l i ng
pagmamahal	p a g m a m a h a l
pagmamalabis	p a g m a m a l a b i s
pagmamalupit	p a g m a m a l u p i t
pagmamasid	p a g m a m a s i d
pagmonitor	p a g m u n i t o r
pagnanais	p a g n a n a q i s
pagnenegosyo	p a g n e n e g o sh o q
pagod	p a g o d
pagod-pagod	p a g o d p a g o d
pagong	p a g o ng
pagpalain	p a g p a l a q i n
pagpanaw	p a g p a n aw
pagpanhik	p a g p a n h i k
pagpapadala	p a g p a p a d a l a
pagpapagayag	p a g p a p a g a y a g
pagpapahusay	p a g p a p a h u s ay
pagpapakilalang	p a g p a p a k i l a l a ng
pagpapakitang	p a g p a p a k i t a ng
pagpapala	p a g p a p a l a
pagpapalago	p a g p a p a l a g o q
pagpapalakas	p a g p a p a l a k a s
pagpapaliwanag	p a g p a p a l i w a n a g
pagpaparami	p a g p a p a r a m i
pagpapatupad	p a g p a p a t u p a d
pagpapaunlad	p a g p a p a q u n l a d
pagpapautang	p a g p a p a q u t a ng
pagpasok	p a g p a s o k
pagpili	p a g p i l i
pagpupulong	p a g p u p u l o ng
pagpupulupot	p a g p u p u l u p o t
pagrerehistro	p a g r e r e h i s t r o
pagsakatuparan	p a g s a k a t u p a r a n
pagsali	p a g s a l i q
pagsalin	p a g s a l i n
pagsampalataya	p a g s a m p a l a t a y a
pagsang-ayon	p a g s a ng q a y u n
pagsanjan	p a g s a n h a n
pagsapit	p a g s a p i t
pagsasa-larawan	p a g s a s a l a r a w a n
pagsasabi	p a g s a s a b i
pagsasalaysay	p a g s a s a l a y s ay
pagsasalita	p a g s a s a l i t a
pagsasama	p a g s a s a m a
pagsasamang	p a g s a s a m a ng
pagsasapuso	p a g s a s a p u s o q
pagsasara	p a g s a s a r a
pagsigla	p a g s i g l a
pagsikat	p a g s i k a t
pagsilip	p a g s i l i p
pagsisisi	p a g s i s i s i
pagsisiwalat	p a g s e s e w a l a t
pagsubok	p a g s u b o k
pagsugpo	p a g s u g p o
pagsulat	p a g s u l a t
pagsulong	p a g s u l o ng
pagsuot	p a g s u q u t
pagsusugal	p a g s u s u g a l
pagsusuka	p a g s u s u k a
pagsusulit	p a g s u s u l i t
pagsusuri	p a g s u s u r i
pagsusuring	p a g s u s u r i ng
pagtaas	p a g t a a s
pagtambalin	p a g t a m b a l i n
pagtanda	p a g t a n d a
pagtanggi	p a g t a ng g i
pagtapak	p a g t a p a k
pagtatapat	p a g t a t a p a t
pagtatapos	p a g t a t a p o s
pagtatrabaho	p a g t a t r a b a h o q
pagtawid	p a g t a w i d
pagtaya	p a g t a y a
pagtigil	p a g t i g i l
pagtitiis	p a g t i t i q i s
pagtitipon	p a g t i t i p o n
pagtitiwala	p a g t i t i w a l a
pagtugis	p a g t u g i s
pagtukoy	p a g t u k oy
pagtulog	p a g t u l o g
pagtulong	p a g t u l o ng
pagtupad	p a g t u p a d
pagtutulad	p a g t u t u l a d
pagtutuos	p a g t u t u q o s
pagtuturo	p a g t u t u r o
pagtutuunan	p a g t u t u q u n a n
pagudpud	p a g u d p u d
pagyabong	p a g y a b o ng
pagyamanin	p a g y a m a n i n
pahayag	p a h a y a g
pahina	p a h i n a
pahinga	p a h i ng a
pahirin	p a h i r i n
paki	p a k i
pakialam	p a k i q a l a m
pakikidigma	p a k i k i d i g m a
pakikilaban	p a k i k i l a b a n
pakikinabangan	p a k i k i n a b a ng a n
pakikipagkasundo	p a k i k i p a g k a s u n d o
pakikipaglaban	p a k i k i p a g l a b a n
pakikipagpalit	p a k i k i p a g p a l i t
pakikipagpulong	p a k i k i p a g p u l o ng
pakikipagtalik	p a k i k i p a g t a l i k
pakikiramay	p a k i k i r a m ay
pakinabang	p a k i n a b a ng
pakiramdam	p a k i r a m d a m
pakiusap	p a k i q u s a p
pakiwari	p a k i w a r i
pako	p a k o q
pakpak	p a k p a k
paksang	p a k s a ng
paksiw	p a k s iw
pal	p a l
pala	p a l a
pala-pala	p a l a p a l a q
palaaral	p a l a a r a l
palabok	p a l a b o k
palace	p a l a s
palad	p a l a d
palagi	p a l a g i
palagiang	p a l a g i q a ng
palaging	p a l a g i ng
palakas	p a l a k a s
palaki	p a l a k i
palakingkingan	p a l a k i ng k i ng a n
palakol	p a l a k o l
palakpak	p a l a k p a k
palakpakan	p a l a k p a k a n
palalabasin	p a l a l a b a s i n
palalakasin	p a l a l a k a s i n
palalawakin	p a l a l a w a k i n
palaman	p a l a m a n
palang	p a l a ng
palasingsingan	p a l a s i ng s i ng a n
palasyo	p a l a sh o q
palawan	p a l a w a n
palawigin	p a l a w i g i n
palay	p a l ay
palayain	p a l a y a q i n
palayan	p a l a y a n
palayok	p a l a y o k
palengke	p a l e ng k e
palibhasa'y	p a l i b h a s ay
paligid	p a l i g i d
paliparan	p a l i p a r a n
palitan	p a l i t a n
palitaw	p a l i t aw
paliwanag	p a l i w a n a g
palm	p a l m
palmas	p a l m a s
palo-sebo	p a l o q s e b o
pamagat	p a m a g a t
pamahalaan	p a m a h a l a q a n
pamahiin	p a m a h i q i n
pamahiing	p a m a h i q i ng
pamalo	p a m a l o
pamamaga	p a m a m a g a
pamamagitan	p a m a m a g i t a n
pamamahagi	p a m a m a h a g i
pamamaraan	p a m a m a r a q a n
pamamasyal	p a m a m a sh a l
pamamayagpag	p a m a m a y a g p a g
pamamayan	p a m a m a y a n
pamana	p a m a n a
pamangkin	p a m a ng k i n
pambansa'y	p a m b a n s ay
pambansang	p a m b a n s a ng
pambihirang	p a m b i h i r a ng
pambura	p a m b u r a
pamela	p a m e l a
pamilihan	p a m i l i h a n
pamilihang-mangga	p a m i l i h a ng q m a ng g a
pamilya	p a m i ly a
pamilyang	p a m i ly a ng
pamimili	p a m i m i l i
pamimiliin	p a m i m i l i q i n
paminsan	p a m i n s a n
paminta	p a m i n t a
pamitinan	p a m i t i n a n
pampang	p a m p a ng
pampanga	p a m p a ng g a
pampasaherong	p a m p a s a h e r o ng
pampublikong	p a m p u b l i k o ng
pamumuhay	p a m u m u h ay
pamumuhunan	p a m u m u h u n a n
pamumula	p a m u m u l a
pamumulitika	p a m u m u l i t i k a
pamumuno	p a m u m u n o
pamumuo	p a m u m u q o
pamunuan	p a m u n u q a n
pan	p a n
panahon	p a n a h o n
panahong	p a n a h o ng
panakip-butas	p a n a k i p q b u t a s
panalangin	p a n a l a ng i n
pananagutan	p a n a n a g u t a n
pananakit	p a n a n a k i t
pananalig	p a n a n a l i g
pananaliksik	p a n a n a l i k s i k
pananalita'y	p a n a n a l i t ay
pananambitan	p a n a n a m b i t a n
pananangis	p a n a n a ng i s
pananatili	p a n a n a t i l i q
pananggalang	p a n a ng g a l a ng
pananim	p a n a n i m
panatalihing	p a n a t a l i h i ng
panatilihing	p a n a t i l i h i ng
panawagan	p a n a w a g a n
panay	p a n ay
pancit	p a n s i t
pandacan	p a n d a k a n
pandaigdigang	p a n d a q i g d i g a ng
pandaraya	p a n d a r a y a
pandesal	p a n d i s a l
pang	p a ng
pang-aapi	p a ng q a a p i
pang-aasar	p a ng q a q a s a r
pang-agrikultura	p a ng q a g r i k a l t u r a
pang-anti-hypertension	p a ng q a n t ay h ay p er t e n sh o n
pang-araw-araw	p a ng q a r aw q a r aw
pang-export	p a ng q e k s p o r t
pang-unang	p a ng q u n a ng
pang-uuyam	p a ng q u q u y a m
panga	p a ng a
pangako	p a ng a k o q
pangalan	p a ng a l a n
pangalawa	p a ng a l a w a
pangalawang	p a ng a l a w a ng
panganay	p a ng a n ay
pangangailangan	p a ng a ng ay l a ng a n
pangangalaga	p a ng a ng a l a g a
pangangalos	p a ng a ng a l o s
pangangarir	p a ng a ng a r e r
pangangaso	p a ng a ng a s o
panganiban	p a ng a n i b a n
pangarap	p a ng a r a p
pangasinan	p a ng a s i n a n
pangat	p a ng a t
pangatlong	p a ng a t l o ng
pangginaw	p a ng g i n aw
pangingilabot	p a ng i ng i l a b o t
pangingisda	p a ng i ng i s d a
pangisda	p a ng i s d a
pangisdaan	p a ng i s d a q a n
pangit	p a ng i t
pangkasal	p a ng k a s a l
pangkat	p a ng k a t
pangsuweldo	p a ng s w e l d o
pangulo	p a ng u l o
pangulong	p a ng u l o ng
pangunahan	p a ng u n a h a n
pangunahing	p a ng u n a h i ng
pangunang	p a ng u n a ng
pangungulila	p a ng u ng u l i l a
pangungusap	p a ng u ng u s a p
pangyayari	p a ng y a y a r i
pangyayaring	p a ng y a y a r i ng
pani	p a n i
panig	p a n i g
paninda	p a n i n d a
paningasin	p a n i ng a s i n
paningin	p a n i ng i n
paninigarilyo	p a n i n i g a r i ly o q
paninikil	p a n i n i k i l
paniniwala	p a n i n i w a l a q
paniniwalang	p a n i n i w a l a ng
panipit	p a n i p i t
panitikang	p a n i t i k a ng
paniwala	p a n i w a l a q
panlabas	p a n l a b a s
panlipunan	p a n l i p u n a n
pansamantala	p a n s a m a n t a l a
pansamantalang	p a n s a m a n t a l a ng
pansin	p a n s i n
pantalong	p a n t a l o ng
pantas-lahi	p a n t a s l a h i
pantay-pantay	p a n t a y p a n t ay
panukala	p a n u k a l a
panukat	p a n u k a t
panuntunan	p a n u n t u n a n
panunumpa	p a n u n u m p a
panuto	p a n u t o
papa	p a p a
papag	p a p a g
papalapit	p a p a l a p i t
papalo	p a p a l o
papasok	p a p a s o k
papel	p a p i l
papers	p a p er s
papunta	p a p u n t a
papuntang	p a p u n t a ng
papupuntahan	p a p u p u n t a h a n
paputok	p a p u t o k
para	p a r a
paraan	p a r a q a n
paraisong	p a r a q i s o ng
paranaque	p a r a ny a k e
parang	p a r a ng
pari	p a r i
parin	p a r i n
paring	p a r i ng
parirala't	p a r i r a l a t
pariralang	p a r i r a l a ng
park	p a er k
parklane	p a er k l ey n
paroroonan	p a r o r o q o n a n
parte	p a r t e
partikular	p a r t i k u l a er
partner	p a r t n er
partners	p a r t n er s
party	p a r t i
paruruonan	p a r o r o q o n a n
pasahero	p a s a h e r o
pasahod	p a s a h o d
pasakop	p a s a k o p
pasalubong	p a s a l u b o ng
pasaporte	p a s a p o r t i
pasasalamat	p a s a s a l a m a t
pasaway	p a s a w a y
pasay	p a s ay
pasensiya	p a s e n s h a
pasensya	p a s e n sh a
pasig	p a s i g
pasingaw	p a s i ng aw
pasiyang	p a sh a ng
pasko	p a s k o
paso	p a s o
paso-paso	p a s o p a s o
pasonanca	p a s u n a ng k a
pasuin	p a s u q i n
pasukin	p a s u k i n
pasyalan	p a sh a l a n
pasyante	p a sh a n t i
pasyente	p a sh e n t e
pata	p a t a
patak	p a t a k
patak-ulan	p a t a k q u l a n
patakaran	p a t a k a r a n
patalastas	p a t a l a s t a s
patalim	p a t a l i m
patani	p a t a n i
patarakan	p a t a r a k a n
patawad	p a t a w a d
patawarin	p a t a w a r i n
patay	p a t ay
patayin	p a t a y i n
patayu-tayo	p a t a y u t a y o q
pateros	p a t i r o s
pati	p a t i
patibong	p a t i b o ng
patid	p a t i d
patilya	p a t i ly a
patio	p a t i y ow
patis	p a t i s
patlang	p a t l a ng
patnubay	p a t n u b ay
patok	p a t o k
patricia	p a t er i sh a
patrick	p a t er i k
patubig	p a t u b i g
patuloy	p a t u l oy
patunay	p a t u n ay
patungkol	p a t u ng k o l
patungo	p a t u ng o
patungong	p a t u ng o ng
paul	p aw l
paulit	p a q u l i t
paulit-ulit	p a q u l i t q u l i t
paulo	p aw l o
paumanhin	p a q u m a n h i n
paunti	p a q u n t i
paunti-unti	p a q u n t i q u n t i
paunting	p a q u n t i ng
pavilion	p a v i ly uh n
pawang	p a w a ng
pawikan	p a w i k a n
pawis	p a w i s
payabang	p a y a b a ng
payo	p a y o q
payong	p a y o ng
paz	p a z
pbc	p i b i s i
pcci	p i s i s i q ay
pci	p i s i q ay
pearl	p er l
pebrero	p e b r e r o
pedestal	p e d e s t a l
pedro	p e d r o
peke	p e k e
pekeng	p e k e ng
pelikula	p e l i k u l a
peninsula	p e n i n s u l a
per	p e r
percent	p e r s e n t
perez	p e r e s
performance	p er f er m a n s
pero	p e r o
personalidad	p er s o n a l i d a d
perya't	p e r y a t
pesos	p e s o s
peste	p e s t e
peter	p i t e r
petrolyo	p e t r o ly o q
petron	p e t r o n
pgma	p g m a
phil	f i l
phil-export	f i l q e k s p o er t
philex	f i l i k s
philippine	f i l i p i n
philippines	f i l i p i n s
philtrust	f i l t er a s t
phivolcs	f i v o l s i s
phone	f ow n
pia	p i y a
piatco	p i y a t k o
pichi-pichi	p i ch i p i ch i q
pigilan	p i g i l a n
pigilin	p i g i l i n
pigsa	p i g s a
pihikang	p i h i k a ng
pilak	p i l a k
pilandok	p i l a n d o k
pili	p i l i
pilikmata	p i l i k m a t a
piling	p i l i ng
pilipinas	p i l i p i n a s
pilipino	p i l i p i n o
pilipino'y	p i l i p i n oy
pilipinong	p i l i p i n o ng
pilit	p i l i t
piloto	p i l o t o
pilyo	p i ly o q
pimples	p i m p l e s
pinababayaan	p i n a b a b a y a q a n
pinag-aaralan	p i n a g q a q a r a l a n
pinag-iingat	p i n a g q i i ng a t
pinag-tibay	p i n a g q t i b ay
pinagbabayaran	p i n a g b a b a y a r a n
pinagbigyan	p i n a g b i g y a n
pinagbilhan	p i n a g b i l h a n
pinagbuhatan	p i n a g b u h a t a n
pinagdarayo	p i n a g d a r a y o q
pinagkaiba	p i n a g k a q i b a
pinagkainan	p i n a g k a q i n a n
pinagkakakitaan	p i n a g k a k a k i t a q a n
pinagkayarian	p i n a g k a y a r i q a n
pinagkukublihan	p i n a g k u k u b l i h a n
pinagkukunan	p i n a g k u k u n a n
pinaglabanan	p i n a g l a b a n a n
pinagmulan	p i n a g m u l a n
pinagmulang	p i n a g m u l a ng
pinagpapawisan	p i n a g p a p a w i s a n
pinagpupugaran	p i n a g p u p u g a r a n
pinagsamang	p i n a g s a m a ng
pinagtatamasa	p i n a g t a t a m a s a
pinagtibay	p i n a g t i b ay
pinagtulung-tulungan	p i n a g t u l o ng t u l u ng a n
pinagtutulungan	p i n a g t u t u l u ng a n
pinagtutuonan	p i n a g t o t o q o n a n
pinagulungan	p i n a g u l u ng a n
pinaka-mababang	p i n a k a q m a b a b a ng
pinaka-mataas	p i n a k a q m a t a q a s
pinaka-matinding	p i n a k a q m a t i n d i ng
pinakabiniyayaan	p i n a k a b i ny a y a q a n
pinakabukang	p i n a k a b u k a ng
pinakaimportanteng	p i n a k a q i m p o r t a n t i ng
pinakainteresado	p i n a k a q i n t e er e s a d o
pinakakaraniwang	p i n a k a k a r a n i w a ng
pinakakatawanan	p i n a k a k a t a w a n a n
pinakamababang	p i n a k a m a b a b a ng
pinakamaingay	p i n a k a m a q i ng ay
pinakamalawak	p i n a k a m a l a w a k
pinakamataas	p i n a k a m a t a q a s
pinakamatalik	p i n a k a m a t a l i k
pinakamatanda	p i n a k a m a t a n d a
pinakapaborito	p i n a k a p a b o r i t o
pinakapaboritong	p i n a k a p a b o r i t o ng
pinakatahimik	p i n a k a t a h i m i k
pinakbet	p i n a k b i t
pinakikingan	p i n a k i k i ng a n
pinakikinggan	p i n a k i k i ng g a n
pinakiusapan	p i n a k a q u s a p a n
pinakuluan	p i n a k u l u q a n
pinalakas	p i n a l a k a s
pinalaman	p i n a l a m a n
pinamagatang	p i n a m a g a t a ng
pinamamahalaan	p i n a m a m a h a l a q a n
pinangalanang	p i n a ng a l a n a ng
pinangat	p i n a ng a t
pinanggalingan	p i n a ng g a l i ng a n
pinangulila	p i n a ng u l i l a
pinaniniwalaang	p i n a n i n i w a l a q a ng
pinansyal	p i n a n sh a l
pinapanood	p i n a p a n u d
pinapansin	p i n a p a n s i n
pinapayagan	p i n a p a y a g a n
pinaplano	p i n a p l a n o
pinapurihan	p i n a p u r i h a n
pinaputok	p i n a p u t o k
pinas	p i n a s
pinasabog	p i n a s a b u g
pinasan	p i n a s a n
pinaso	p i n a s o
pinasok	p i n a s o k
pinatawad	p i n a t a w a d
pinatawan	p i n a t a w a n
pinaupo	p i n a q o p u
pinilit	p i n i l i t
pinipitas	p i n i p i t a s
pinirito	p i n i r i t o
pink	p i n k
pinoy	p i n oy
pinsan	p i n s a n
pinto	p i n t o
pintong	p i n t o ng
pintuan	p i n t u q a n
pinuno	p i n u n o
pinuri	p i n u r i
pinutol	p i n u t o l
pipiliin	p i p i l i q i n
pipit	p i p i t
pirasong	p i r a s o ng
pisara	p i s a r a
pisngi	p i s ng i q
pisngi'y	p i sh ng i
piso	p i s o
pisong	p i s o ng
pistang-bayan	p i s t a ng b a y a n
pito	p i t o
pito-pito	p i t o p i t o
pitong	p i t o ng
pitumpu	p i t u m p u
pitumpu't	p i t u m p u t
pitumpung	p i t u m p u ng
piyaya	p i y a y a
place	p l ey s
plain	p l a q i n
plan	p l a n
planning	p l a n i ng
plano	p l a n o
planta	p l a n t a
plantang	p l a n t a ng
plantasyon	p l a n t a sh o n
plasa	p l a s a
plastik	p l a s t i k
plataporma	p l a t a p o r m a
platelets	p l a t e l e t s
player	p l ey er
plaza	p l a s a
pldt	p l d t
plema	p l e m a
po	p o
pochero	p o ch e r o
poea	p o e y a
point	p oy n t
points	p oy n t s
polisiya	p o l i s i y a
political	p o l i t i k a l
pollen	p o l e n
polo	p o l o
pondo	p o n d o
pondohan	p o n d o h a n
pondong	p o n d o ng
pong	p o ng
pook	p o o k
poong	p o q o ng
popondohan	p o p o n d o h a n
poprotektahan	p o p r o t e k t a h a n
porsiyento	p o er sh e n t o
porsyento	p o er sh e n t o
porsyentong	p o er sh e n t o ng
posible	p o s i b l i
posibleng	p o s i b l e ng
posisyon	p o s i sh uh n
potensyal	p o t e n sh a l
power	p a w er
powerplant	p a w er p l a n t
pray	p r ay
prayle	p r ay l e
prepaid	p r i p a q i d
preparedness	p r i p a r e d n e s
presentasyon	p r e s e n t a sh u n
presidential	p r e s i d e n t i y a l
press	p er e s
presyo	p r e sh o q
presyon	p r e sh o n
price	p er ay s
prime	p er ay m
prince	p er e n s
princesa	p er e n s e s a
principal	p er i n s i p a l
prinsipal	p er i n s i p a l
prinsipe	p er i n s i p i
prito	p r i t o
privatization	p r ay v a t i z a sh y u n
probabilidad	p r o b a b i l i d a d
probinsya	p r o b i n sh a
problema	p r o b l e m a
problems	p r o b l e m s
producers	p r o d u s er s
product	p er o d uh k t
products	p er o d uh k t s
produksiyon	p r o d u k sh o n
produksyon	p r o d u k sh o n
produkto	p r o d u k t o
produktong	p r o d u k t u ng
program	p er ow g er ae m
programa	p r o g r a m a
programang	p r o g r a m a ng
progresibong	p r o g r e s i b o ng
project	p r o h i k t
projection	p r o h e k sh uh n
projects	p r o h i k t s
promo	p r o m o
prop	p r o p
properties	p r o p er t i s
proseso	p r o s e s o
proteksyon	p r o t e k sh o n
providers	p r o v e d er s
proyekto	p r o y e k t o
proyektong	p r o y e k t o ng
prusisyon	p r u s i sh uh n
pse	p s
puberty	p u b er t i
public	p a b l i k
publikasyon	p u b l i k a sh u n
publiko	p u b l i k o
puerto	p u er t o
pugad	p u g a d
puhunan	p u h u n a n
pukol	p u k o l
pula	p u l a
pulang	p u l a ng
pulis	p u l i s
pulitika	p o l i t i k a
pulo	p u l o
pulog	p u l o g
pulong	p u l o ng
pulutan	p u l u t a n
pulutin	p u l u t i n
pumalo	p u m a l o
pumapalo	p u m a p a l o
pumasok	p u m a s o k
pumayag	p u m a y a g
pumila	p u m i l a q
pumili	p u m i l i q
pumitas	p u m i t a s
pumulas	p u m u l a s
pumunta	p u m u n t a
pumuputok	p u m u p u t o k
pumutak	p u m u t a k
pumutok	p u m u t o k
pumuwesto	p u m w e s t o
punan	p u n a n
punasan	p u n a s a n
punasi	p u n a s i
pundasyon	p u n d a sh u n
puno	p u n o
punong	p u n o ng
punong-saging	p u n o ng q s a g i ng
punongkahoy	p u n o ng k a h oy
punongkahoyy	p u n o ng k a h oy i
punta	p u n t a
puntahan	p u n t a h a n
punung-puno	p u n u ng p u n o
pupunga-pungas	p u p u ng a p u ng a s
pupunta	p u p u n t a
pupursigi	p u p u r s i g i
puri	p u r i
purines	p o r ay n s
pusa	p u s a
puso	p u s o q
pusod	p u s o d
puson	p u s o n
pusong	p u s o ng
putahe	p u t a h e
puti	p u t i q
puto	p u t o
putulin	p u t u l i n
puwede	p u w e d e
puwedeng	p u w e d i ng
puwet	p w e t
puwit	p u w e t
puwitan	p u w i t a n
puyat	p o y a t
puyo	p u y o q
pwede	p w e d i
pwedeng	p w e d i ng
pwesto	p w e s t o
quarter	k a r t e r
quezon	k e z o n
quiapo	k y a p o q
r	r
raan	r a q a n
raang	r a q a ng
rachelle	r ey ch e l
radio	r a jh o
rafael	r a f a e l
rag	r a g
ragat	r a g a t
raisers	r a q i s er s
ralph	er ae l f
ramos	r a m o s
randy	r a n d i
rash	r a sh
rate	r ey t
ratio	er ey sh o
raul	r a q u l
raw	r aw
ready	r e q a d i
reality	r e q a l i t i
rebecca	r e b e k a
recess	r i s e s
record	er e k o er d
recreational	r i k r e ey sh u n a l
red	er e d
reef	r i f
reform	er i f er m
regalong	r e g a l o ng
regency	r i jh e n s i
regional	r i jh u n a l
regions	er i jh uh n s
register	r e jh e s t er
regular	r e g y u l a r
rehabilitasyon	r e h a b i l i t a sh u n
reklamo	r e k l a m u
reklamong	r e k l a m u ng
relleno	r e ly e n o
remittances	r e m i t a n s e s
renta	r e n t a
repair	r i p a er
reporma	r e p o r m a
reprersentative	r e p r e er s e n t a t i v
reserve	r e s er v
reserves	r e s er v e s
residence	r e s i d e n s
residences	r e s i d e n s e s
resolbahin	r e s o l b a h i n
resolusyon	r e s o l u sh o n
resort	r i s o er t
resources	r i s o o er s e s
restrictions	r e s t r i k sh uh n s
resty	r e s t i
resulta	r e s u l t a
results	r e s u l t s
retail	r e t e l
reuters	r i u t er s
revenue	r i v e n w e
rey	er i
reyes	r i y e s
rhinitis	r h i n i t i s
ricardo	r i k a r d o
rice	r ay s
richard	r i ch a er d
rin	r i n
ring	r i ng
ringring	r i ng r i ng
rito	r i t o
riu-kiu	r i y u k y u
river	r i v er
rivera	r i v e r a
riyan	r i y a n
rizal	r i z a l
rmn	r m n
road	r ow d
robina	er o b i n a
robinsons	er o b i n s o n s
robles	r o b l e s
rockwell	r a k w e l
rodel	r o d e l
rodolfo	r o d o l f o
rodrigo	r o d r e g o
roger	r o jh o
rollback	r o l b a k
rommel	r o m e l
romualdez	r o m w a l d e s
romulo	r o m o l o
ronald	r u n a l d
room	r u m
roon	r o q o n
roong	r o q o ng
rosa	r o s a
rosario	r o s a r e y o
rosas	r o s a s
rosemary	r o s e m e r i
rosenian	r o s e n i q a n
rosie	r o s i
routines	r o t i n s
rowena	r o w e n a
roxas	r o h a s
roy	r oy
rp	r p
rules	r u l s
runners	r u n er s
rusya	r u sh a
ryan	r a y a n
sa	s a
sa'yong	s a y o ng
saan	s a q a n
saan-saan	s a q a n q s a q a n
saang	s a q a ng
saapektadong	s a q a p e k t a d o ng
sabado	s a b a d o
sabay	s a b ay
sabay-sabay	s a b ay q s a b ay
sabi	s a b i
sabi-sabi	s a b i s a b i
sabihin	s a b i h i n
sabunang	s a b u n a ng
sadyang	s a d jh a ng
sagada	s a g a d a
saging	s a g i ng
sagipin	s a g i p i n
sagot	s a g o t
sagun	s a g u n
sagutang	s a g u t a ng
sagutin	s a g u t i n
sahig	s a h i g
sahod	s a h o d
sailalim	s a q i l a l i m
sailors	s a q i l o er s
saka	s a k a q
sakaling	s a k a l i ng
sakayan	s a k a y a n
sakdal-sakdal	s a k d a l q s a k d a l
sakit	s a k i t
sakitin	s a k i t i n
saklap	s a k l a p
sakong	s a k u ng
saksakan	s a k s a k a n
salamat	s a l a m a t
salamin	s a l a m i n
salang	s a l a ng
salapi	s a l a p i
salary	s a l e r i
salazar	s a l a z a er
salcedo	s a l s e d o
sale	s a l
salihan	s a l i h a n
salita	s a l i t a
salitang	s a l i t a ng
salitay	s a l i t ay
salle	s a l
salon	s a l o n
salop	s a l o p
saltwater	s a l t w o t er
salungguhitan	s a l u ng g u h i t a n
salvador	s a l b a d o r
samakalawa	s a m a k a l a w a
samantala	s a m a n t a l a
samantala'y	s a m a n t a l ay
samantalang	s a m a n t a l a ng
samasama	s a m a s a m a
sambayanang	s a m b a y a n a ng
samie	s a m i
sampaloc	s a m p a l o k
sampu	s a m p u
sampung	s a m p u ng
san	s a n
sana	s a n a q
sanayan	s a n a y a n
sanayin	s a n a y i n
sanchez	s a n ch e s
sandali	s a n d a l i q
sandaling	s a n d a l i ng
sandra	s a n d er a
sanga	s a ng a
sanggol	s a ng g o l
sangkap	s a ng k a p
sangko	s a ng k o
sangre'	s a ng r e
sanhi	s a n h i
sanlang	s a n l a ng
santa	s a n t a
santakrusan	s a n t a k r u s a n
santiago	s a n t i y a g o q
santo	s a n t o
santos	s a n t o s
sapa	s a p a
sapagkat	s a p a g k a t
sapantahin	s a p a n t a h i n
sapat	s a p a t
sapatos	s a p a t o s
sapilitang	s a p i l i t a ng
sapin-sapin	s a p i n q s a p i n
sar	s a r
sara	s a r a
sarah	s a r a
sarciado	s a r sh a d o
sardinas	s a er d i n a s
sarili	s a r i l i q
sariling	s a r i l i ng
sariwa	s a r i w a
sariwang	s a r i w a ng
sarmiento	s a r m i e n t o
saru	s a r u
sasabihin	s a s a b i h i n
sasagot	s a s a g o t
sasak-yan	s a s a k q y a n
sasaktan	s a s a k t a n
sasakyan	s a s a k y a n
sasaluhin	s a s a l u h i n
sasama	s a s a m a
sasariwain	s a s a r i w a q i n
satisfied	s a t i s f ay d
saudi	s o d i
savings	s ey v i ng s
sawaling	s a w a l i ng
sawi	s a w i
sayangin	s a y a ng i n
sayaw	s a y aw
sayo	s a y o q
sbma	s b m a
scarf	s k e er f
school	s k u l
scrambled	s k r a m b l d
seafarers	s i f a r er s
sean	sh ao n
seater	sh ao t er
seatwork	s i t w er k
sebastian	s e b a s ch a n
secretary	s i k r e t a r i
section	s e k sh uh n
sector	s i k t o r
security	s e k y u r i t i
segundo	s i g u n d o
segusegundo	s e g u s e g u n d u
sekretarya	s e k r e t a r y a
sekretaryo	s e k r e t a r y o q
sektor	s e k t o r
selling	s e l i ng
semana	s e m a n a
semento	s e m e n t o
semplang	s e m p l a ng
sentimetro	s e n t i m e t r o
sentimo	s e n t i m o
sentimos	s e n t i m o s
sentral	s e n t r a l
sentro	s e n t r o
senyales	s e n y a l e s
serafin	s e r a f i n
serbisyo	s e er b i sh o
serbisyong	s e er b i sh u ng
seremonya	s e er m o ny a
service	s er v i s
serviced	s er v i s t
services	s er v i s e s
serye	s e er y e
seryoso	s e er y o s o
sesyon	s e sh o n
setyembre	s e t y e m b r e
seven	s e v e n
seventy	s e v e n t
seventy-six	s e v e n t y s i k s
sex	s e k s
shangri-la	sh a ng r i l a
shangri-la's	sh a ng er i l a s
shares	sh ey r s
sharing	sh a r i ng
sharon	sh a r o n
she	sh i
sheila	sh i l a
shell	sh e l
shellfish	sh e l f i sh
sherwin	sh e r w i n
sheryl	sh e er y l
shift	sh i f t
short-term	sh o t t er m
show	sh ow
shrine	sh er ay n
shut	sh u t
si	s i
siargao	sh a r g aw
sibugay	s i b u g ay
sibulan	s i b u l a n
sigaw	s i g aw
sige	s i g i
sigla	s i g l a
signal	s i g n a l
signs	s i g n s
sigurado	s i g u r a d o
siguradong	s i g u r a d o ng
siguro	s i g u r o
siguro'y	s i g u r uy
sigwa	s i g w a
sikat	s i k a t
sikatuna	s i k a t u n a
sikmura	s i k m u r a
siko	s i k o
sikolohiya	s i k o l o h i y a
sila	s i l a
sila'y	s i l ay
silang	s i l a ng
silangan	s i l a ng a n
silanganan	s i l a ng a n a n
silangang	s i l a ng a ng
silbi	s i l b w i q
silid	s i l i d
silid-aralan	s i l i d q a r a l a n
silliman	s i l i m a n
silverstone	s i l v er s t ow n
silya	s i ly a
simbahan	s i m b a h a n
simbolo	s i m b o l o
simula	s i m u l a
simulan	s i m u l a n
sina	s i n a
sinabi	s i n a b i
sinabihan	s i n a b i h a n
sinagot	s i n a g o t
sinalubong	s i n a l u b o ng
sinangag	s i n a ng a g
sinasabi	s i n a s a b i
sinasabing	s i n a s a b i ng
sinasakyan	s i n a s a k y a n
sinasamahan	s i n a s a m a h a n
sinat	s i n a t
singalong	s i ng g a l o ng
singapore	s i ng g a p o er
singaw	s i ng aw
singil	s i ng i l
singit	s i ng i t
singson	s i ng s u n
sinigang	s i n i g a ng
sinigid	s i n i g i d
siniguro	s i n i g u r o
sinimula	s i n i m u l a
sinimulan	s i n i m u l a n
sinipit	s i n i p i t
sinira	s i n i r a
sinisiguro	s i n i s i g u r o
sinisimulan	s i n i s i m u l a n
sinkwenta	s i n k w e n t a
sino	s i n o
sino'ng	s i n o ng
sinong	s i n o ng
sintido	s i n t i d o
sintomas	s i n t o m a s
sinu-sino	s i n o q s i n o
sinulat	s i n u l a t
sinuman	s i n u m a n
sinumang	s i n u m a ng
sinusumpong	s i n u s u m p o ng
sipit	s i p i t
sipon	s i p o n
sirkulasyon	s i r k u l a sh o n
sisimulan	s i s i m u l a n
sisxty	s i s k s t i
sitaw	s i t aw
sitwasyon	s i t w a sh o n
six	s i
sixty	s i t i
siya	s i y a
siya'y	s i y a y
siyam	s i y a m
siyam-siyam	sh a m q s i y a m
siyamnapu	sh a m n a p u
siyamnapu't	sh a m n a p u t
siyamnapung	sh a m n a p u ng
siyang	sh a ng
siyudad	sh y u d a d
sm	s m
small	s m o l
smart	s m a er t
smes	s m s
sobrang	s u b r a ng
sofitel	s o f i t i l
soleil	s o l ey
soliman	s o l i m a n
solusyon	s o l u sh o n
some	s o m e
somerset	s o m er s e t
sona	s o n a
sopas	s o p a s
sore	s o er
sorghum	s o er g h u m
soriso	s o r i s o
sorsogon	s o r s o g o n
southeast	s aw d i s t
spa	s p a
spam	s p a m
specific	s p i s i p i k
speed	s p i d
spelling	s p e l i ng
spirit	s p i r i t
spokesman	s p ow k s m a n
spokesperson	s p ow k s p er s o n
sports	s p o er t s
spots	s p ao t s
sta	s t a
stability	s t a b i l i t i
stage	s t ey jh
star	s t a er
state	s t ey t
station	s t ey sh o n
stations	s t ey sh o n s
stella	s t e l a
stephen	s t e f e n
stock	s t o k
streamers	s t r e q a m er s
stress	s t r e s
subali't	s u b a l i t
subalit	s u b a l i t
subic	s u b i k
subject	s u b h i k t
subo-subo-subo	s u b o q s u b o q s u b u q
subok-subok	s u b o k q s u b o k
subscriber	s u b s k r i b er
substandard	s u b s t a n d a er d
subterranean	s a b t e er ey ny a n
subukan	s u b u k a n
sugar-free	s u g a r q f r i
sugat	s u g a t
sugpuin	s u g p o q i n
suhestiyon	s u h e s ch o n
suit	s u t
suites	s u t s
suka	s u k a
sukat	s u k a t
sukat-sukat	s u k a t q s u k a t
suklayin	s u k l a y i n
suklob	s u k l u b
sulat	s u l a t
sulatan	s u l a t a n
suliranin	s u l i r a n i n
sultan	s u l t a n
sumagot	s u m a g o t
sumakay	s u m a k ay
sumalat	s u m a l a t
sumali	s u m a l i q
sumama	s u m a m a
suman	s u m a n
sumangayon	s u m a ng a y o n
sumapi	s u m a p i
sumapit	s u m a p i t
sumasadsad	s u m a s a d s a d
sumasakit	s u m a s a k i t
sumasaklaw	s u m a s a k l aw
sumasalang	s u m a s a l a ng
sumatra	s u m a t r a
sumayaw	s u m a y aw
sumibol	s u m i b o l
sumigaw	s u m i g aw
sumigla	s u m i g l a
sumikat	s u m i k a t
sumisikat	s u m i s i k a t
summit	s u m i t
sumubok	s u m u b o k
sumuko	s u m u k o
sumulat	s u m u l a t
sumunod	s u m u n o d
sumusulong	s u m u s u l o ng
sumusunod	s u m u s u n o d
sumusuporta	s u m u s u p o er t a
sun	s u n
sunburn	s uh n b er n
sundalo	s u n d aw l o
sundan	s u n d a n
sundin	s u n d i n
sundo	s u n d o
sunog	s u n o g
sunog-sunog	s u n o g q s u n o g
suot	s u q o t
super	s u p e r
suplay	s u p l ay
suporta	s u p o er t a
supot	s u p o t
surfboard	s er f b ow a er d
suriing	s u r i q i ng
survey	s u r v i
sus	s u s
susi	s u s i
suso	s u s o q
susulat	s u s u l a t
susulatan	s u s u l a t a n
susunod	s u s u n o d
susuriin	s u s u r i q i n
susuriing	s u s u r i q i ng
suweldo	s w e l d o
suyod	s u y o d
swelling	s w e l i ng
systems	sh s t e m s
syudad	sh y u d a d
t	t
t-back	t b a k
t-bills	t b i l s
taal	t a q a l
taas	t a q a s
taba	t a b a
tabangao	t a b a ng a q o
tabi	t a b i q
tabing	t a b i ng
tabing-ilog	t a b i ng q i l o g
table	t a b l
tablet	t a b l e t
tabuk	t a b u k
tacloban	t a k l o b a n
tadyang	t a d jh a ng
taft	t a f t
tag-araw	t a g q a r aw
tag-ulan	t a g q u l a n
taga	t a g a
taga-bundok	t a g a q b u n d o k
taga-holandang	t a g a h o l a n d a ng
taga-ibang	t a g a q i b a ng
taga-japon	t a g a q h a p o n
tagal	t a g a l
tagalog	t a g a l o g
tagapagtaguyod	t a g a p a g t a g u y u d
tagarito	t a g a r i t o
tagaytay	t a g ay t ay
tagbilaran	t a g b i l a r a n
tagbisi	t a g b i s i
tagiliran	t a g i l i r a n
taglagas	t a g l a g a s
taglamig	t a g l a m i g
taglay	t a g l ay
tagsibol	t a g s i b o l
tagtuyot	t a g t u y o t
taguig	t a g u q i g
tahana't	t a h a n a t
tahimik	t a h i m i k
tahong	t a h o ng
tainga	t ey ng a
taipei	t a q i p e i q
takalan	t a k a l a n
takbo	t a k b o
takbuhan	t a k b u h a n
takda	t a k d a
takdang	t a k d a ng
takdang-aralin	t a k d a ng q a r a l i n
takip	t a k i p
takipsilim	t a k i p s i l i m
takot	t a k o t
takpan	t a k p a n
taktak	t a k t a k
takutin	t a k u t i n
tala	t a l a
tala-tala	t a l a t a l a
talaan	t a l a q a n
talaga	t a l a g a
talagang	t a l a g a ng
talahib	t a l a h i b
talampakan	t a l a m p a k a n
taliwas	t a l i w a s
talon	t a l u n
talukap	t a l u k a p
tama	t a m a
tamang	t a m a ng
tambler	t a m b l er
tamis	t a m i s
tampok	t a m p o k
tan	t a n
tanaw	t a n aw
tanda	t a n d a
tandag	t a n d a g
tanggal	t a ng g a l
tanggapan	t a ng g a p a n
tanggapin	t a ng g a p i n
tanghali	t a ng h a l i q
tanghaling	t a ng h a l i ng
tangi	t a ng i q
tanging	t a ng i ng
tanglay	t a g l ay
tanikalang	t a n i k a l a ng
tanim	t a n i m
tanong	t a n o ng
tao	t a q o
taon	t a q o n
taong	t a q o ng
taong-bayan	t a q u ng b a y a n
taos	t a o s
taoy	t a q oy
tapa	t a p a
tapang	t a p a ng
tapat	t a p a t
tapos	t a p o s
tapsilog	t a p s i l o g
target	t a r jh e t
tarlac	t a r l a k
tasa	t a s a
tasahan	t a s a h a n
task	t a s k
tataas	t a t a q a s
tatahimik	t a t a h i m i k
tatakbo	t a t a k b o
tatangkilikin	t a t a ng k i l i k i n
tatawag	t a t a w a g
tatay	t a t ay
tatayo	t a t a y o q
tatlo	t a t l o
tatlong	t a t l o ng
tatlumpu	t a t l u m p u
tatlumpu't	t a t l u m p u t
tatlumpung	t a t l u m p u ng
tauhan	t a u h a n
taumbayan	t a u m b a y a n
taung	t a u ng
taung-bayan	t a u ng b a y a n
tawa	t a w a
tawag	t a w a g
tax	t ae k s
taxi	t a k s i
tayabas	t a y a b a s
tayga	t a y g a
tayo	t a y o q
tayo'y	t a y oy
tayo-tayo	t a y o t a y o q
tayong	t a y o ng
tbip	t b i p
technologies	t e k n o l o jh i s
techono-park	t e ch o n o p a er k
teenagersdahil	t e e n e jh e r s d a h i l a n
teknolohiya	t e k n o l o h i y a
tele-ofw	t e l e q o f w
telebisyon	t e l e b i sh o n
telecom	t e l e k o m
telecommunication	t e l e k o m y u n i k ey sh o n
telecommunications	t e l e k o m y u n i k ey sh uh n s
telecoms	t e l e k o m s
telephone	t e l e f ow n
tema	t e m a
temperatura	t e m p e r a t u r a
tenor	t e n o r
tensiyong	t e n sh o ng
tenty	t e n t i
teodor	t i y o d o r a
teodora	t y u d o r a
terbinafine	t e r b i n a f ay n
teresita	t e r e s i t a
terminal	t e er m i n a l
termino	t e er m i n o
terorismo	t e r o r i s m o
terorista	t e r o r i s t a
terraces	t e er e s e s
tess	t e s
tessa	t e s a
test	t e s t
tetangco	t e t a ng k o
teves	t e v e s
text	t e k s
tgci	t g s i q ay
thailand	d a q i l a n d
thani	th a n i
that	d a t
the	d uh
thesaurus	d i s o r o s
third	d er d
thirteen	d er t i n
thirty-six	d er t y s i k s
thomas	th o m a s
though	t h aw
thousand	t h aw s a n
three	t r i
thrity	t r i t i
tibak	t i b a k
tibay	t i b ay
tig-isang	t i g q i s a ng
tigdas	t i g d a s
tikatik	t i k a t i k
tikom	t i k o m
tila	t i l a
timbang	t i m b a ng
timog	t i m o g
timog-maynila	t i m o g q m a n i l a
timogy	t i m u g i
timotenho	t i m o t e n h o
tin	t i n
tinaguriang	t i n a g u r i q a ng
tinamaan	t i n a m a q a n
tinamong	t i n a m o ng
tinangay	t i n a ng a y
tinanggap	t i n a ng g a p
tinangka	t i n a ng k a
tinanim	t i n a n i m
tinanong	t i n a n o ng
tinapa	t i n a p a
tinapang	t i n a p a ng
tinapay	t i n a p ay
tinapos	t i n a p o s
tinatamad	t i n a t a m a d
tinatanggap	t i n a t a ng g a p
tinatawag	t i n a t a w a g
tinatayang	t i n a t a y a ng
tinawag	t i n a w a g
tinayak	t i n a y a k
tinda	t i n d a
tindi	t i n d i
ting	t i ng
tinga	t i ng a
tingin	t i ng i n
tingnan	t i ng n a n
tinignan	t i n i g n a n
tinipon	t i n i p o n
tiniyak	t i n I y a k
tinorta	t i n o er t a
tinta	t i n t a
tinubuan	t i n u b u q a n
tinulungan	t i n u l u ng a n
tinupad	t i n u p a d
tinuran	t i n u r a n
tinuruan	t i n u r u q a n
tinusta	t i n u s t a
tinutusok-tusok	t i n u t u s o k t u s o k
tita	t i t a
titigas	t i t i g a s
titigilan	t i t i g i l a n
titik	t i t i k
tito	t i t o
tiwala	t i w a l a
tiwalang	t i w a l a ng
tiya	t i y a
tiyaga	ch a g a
tiyak	t i y a k
tiyakin	t i y a k i n
tiyan	t i y a n
tiyo	t i y o q
tlrc	t l er k
to	t o
tocho	t o ch o q
tocino	t o s i n o
todo	t o d o
tokwa't	t o k w a t
tokyo	t o k y o
tomas	t o m a s
tonelada	t o n e l a d a
tony	t o n i
torres	t o r e s
torta	t o er t a
tos	t o s
total	t o t a l
totoo	t u t u q u
totoo't	t u t u q u t
totoong	t u t u q u ng
tours	t o er s
towers	t a w er s
toxin	t o k s i n
toyo	t o y o q
trabaho	t r a b a h o q
trabahong	t r a b a h o ng
trade	t r ey d
trader	t r ey d er
traders	t r ey d er s
trading	t r ey d i ng
trak	t r a k
trangkaso	t r a ng k a s o
transportation	t r a n s p o er t ey sh o n
treasury	t r i s u r i
tren	t r e n
trilyon	t r i ly o n
trilyong	t r i ly o ng
trip	t r i p
tripod	t r i p u d
tristan	t r i s t a n
tro	t r o
truck	t er uh k
trust	t er a s t
tsina	ch i n a
tsinelas	ch i n e l a s
tsunami	t s u n a m i
tub	t u b
tubbataha	t u b a t a h a
tubig	t u b i g
tubo	t u b o q
tubo-tubo	t u b u t u b o q
tucp	t u k p
tugon	t u g o n
tuguegarao	t u g e g a r aw
tuhod	t u h u d
tula	t u l a
tulad	t u l a d
tulay	t u l ay
tuli	t u l i q
tulo	t u l o
tulong	t u l o ng
tuloy	t u l oy
tuloy-tuloy	t u l oy q t u l oy
tulungan	t u l u ng a n
tuluyan	t u l u y a n
tuluyang	t u l u y a ng
tumaas	t u m a a s
tumaas-bumaba	t u m a q a s q b u m a b a
tumahimik	t u m a h i m i k
tumakas	t u m a k a s
tumakbo	t u m a k b o
tumalon	t u m a l u n
tumanggi	t u m a ng g i
tumapak	t u m a p a k
tumataba	t u m a t a b a
tumatatag	t u m a t a t a g
tumawa	t u m a w a
tumawag	t u m a w a g
tumawid	t u m a w i d
tumayo	t u m a y o q
tumigil	t u m i g i l
tumingin	t u m i ng i n
tumitigas	t u m i t i g a s
tumitindi	t u m i t i n d i
tumor	t u m o r
tumpok	t u m p o k
tumubo	t u m u b o q
tumukol	t u m u k o l
tumunog	t u m u n o g
tumutulong	t u m u t u l o ng
tumutuntong	t u m u t u n t o ng
tunawin	t u n a w i n
tunay	t u n ay
tungkol	t u ng k o l
tungkulin	t u ng k u l i n
tungtong	t u ng t o ng
tunguhin	t u ng u h i n
turan	t u r a n
turismo	t u r i s m o
turista	t u r i s t a
turtle	t uh er t uh l
turuan	t u r u q a n
tustado	t u s t a d o
tutong	t u t o ng
tutugtog	t u t u g t u g
tutulong	t u t u l o ng
tutulungan	t u t u l u ng a n
tutungo	t u t u ng o
tututol	t u t u t o l
tuwa'y	t u w ay
tuwi-tuwina	t u w i t u w i n a
tuwing	t u w i ng
tuyo	t u y u q
tv	t i v i
twelfth	t w e l f th
twelve	t w e l v
twenty	t w e n t i
twenty-five	t w e n t i f ay v
twenty-four	t w e n t i f aw r
twenty-seven	t w e n t i s e v e n
two	t u
type	ch p i
typhoid	t i f ow i d
ubo	q u b o
ubos-ubos	q u b u s q u b u s
ubuhin	q u b u h i n
ubusin	q u b u s i n
ugali	q u g a l i q
ugali't	q u g a l i t
ugaliing	q u g a l i i ng
ugat	q u g a t
ukol	q u k o l
ulan	q u l a n
ulap	q u l a p
ulat	q u l a t
uli	q u l i q
ulila	q u l i l a
uling	q u l i ng
ulit	q u l i t
ulo	q u l o
umaagos	q u m a q a g o s
umaakyat	q u m a q a k y a t
umaalalay	q u m a q a l a l ay
umaalingawngaw	q u m a q a l i ng aw ng aw
umaasa	q u m a q a s a
umaayaw	q u m a q a y aw
umabot	q u m a b o t
umabsent	q u m a b s e n t
umaga	q u m a g a
umagang	q u m a g a ng
umagapay	q u m a g a p ay
umagaw	q u m a g aw
umakyat	q u m a k y a t
umalis	q u m a l i s
umano	q u m a n o
umano'y	q u m a n oy
umapela	q u m o p e l a
umasa	q u m a s a
umawit	q u m a w i t
umeepekto	q u m e q e p e k t o
umepekto	q u m e p e k t o
umihi	q u m i h i
umihip	q u m i h i p
umiibig	q u m i q i b i g
uminom	q u m i n o m
umiwas	q u m i w a s
umpekto	q u m e p e k t o
umpisa	q u m p i s a
umupo	q u m u p o q
umuungal	q u m u q u ng a l
umuwi	q u m u w i
una	q u n a
una't	q u n a t
una'y	q u n ay
unahan	q u n a h a n
unahin	q u n a h i n
unang	q u n a ng
unawaing	q u n a w a q i ng
uncircumcised	q u n s i r k u m k v ay
underground	q a n d e er g er aw n
undersecretary	q a n d er s i k r e t a r i
undp	q u n d i p i
unggoy	q u ng g oy
unidos	q u n i d o s
union	y u ny o n
universal	y u n i v er s a l
university	y u n e b er s i t i
unlad	q u n l a d
unlimited	q u n l i m i t d
unong	q u n o ng
unos	q u n o s
unsatisfied	q u n s a t i s f ay d
unsolicited	q u n s o l i s i t d
unti-unting	q u n t i q u n t i
unuulit	q u n u q u l i t
unwanted	q u n w a n t i d
unwritten	q u n w r e t t e n
up	y u p i
upang	q u p a ng
upo	q u p o
upuan	q u p u q a n
urban	q u r b a n
uri	q u r i
urogynecologist	q u r o jh i n e k o l o jh e s t
us	q o s
usapan	q u s a p a n
users	q u s er s
usman	q u s m a n
uso	q u s o
utak	u t a k
utang	u t a ng
utol	q u t u l
uulitin	q u q u l i t i n
uumpugang	q u q u m p u g a ng
uuwi	q u u w i
uwi	u w i
uwian	w i q a n
valenzuela	v a l e n z w e l a
value	v a l u q
vanessa	v a n e s a
vco	v i s i q ow
vega	v e g a
veranda	v e r a n d a
very	v er i
victor	v i k t o r
victoria	v i k t o r i y a
victoriano	v i k t o r i y a n o
vida	v i d a
vietnam	v iy e t n a m
view	v y u
vigan	v i g a n
villanueva	v i ly a n w e v a
vilma	v i l m a
viral	v i r a l
vista	v i s t a
volante	v o l a n t e
wa	w a
wakas	w a k a s
wala	w a l a q
walang	w a l a ng
walis	w a l i s
walisin	w a l i s i n
walo	w a l o
walong	w a l o ng
walter	w a l t e r
walumpu	w a l u m p u
walumpu't	w a l u m p u t
walumpung	w a l u m p u ng
warehouse	w a r e h aw s
wari'y	w a r i
wash	w a sh
wasto	w a s t o
water	w o t e er
waterfront	w o t e er f er a n t
wb	w b
wedding	w i d i ng
weekend	w e e k e n d
west	w e s t
wheat	w h i t
white	w h i t e
wika	w i k a w
wikang	w i k a ng
william	w i l y u m
winston	w i n s t o n
workers	w er k er s
workshop	w er k sh o p
world	w er l d
y	i
yaan	y a q a n
yabang	y a b a ng
yaman	y a m a n
yamang	y a m a ng
yan	y a n
yang	y a ng
yao'y	y a q oy
yaong	y a q o ng
yata	y a t a
year	y i er
yellow	y e l ow
yelo	y e l o
yong	y u ng
york	y er k
you	y u
your	y u er
yugto	y u g t o
yumuko	y u m u k o
yun	y u n
yung	y o ng
yungib	y o ng i b
yvonne	i v o n
z	z
zamboanga	z a m b w a ng g a
zeny	z e n i
zone	s u n
zubiri	z u b i r i
